147 13
31 2
85 14
124 50
71 96
88 18
82 15
124 98
9 17
140 118
111111011011110111111101011110011111111101111111111111111101a1111111222022222222221222222122102a2010211101111111011111100111011111100010011111111010001111110111
111010110010110011011111101111111101111101110011111111111111a1110002112222020220222211222210202b2212110011101111111011100011101011111111111111011011101111111101
222111001022210221111021010111111111111111100111111001101101a1111110121022012222221021020220212b2121011001111111110111111111100111111110101111110111101111100110
102102010121221122211211211111111101101111111111101111110011a1101111120022211122211102222220122b2022022211110111111111111111100111111111111101111011111010111110
202221212112001010122102211111111111101110101001111011111000a1111112122220021021002201222221222b2220202201110011000110101111111111101110111111111101011011011000
211201200112222101101111211111111100011011111011101001111111a1111000122222201102221202222222222b1010211111111111101110111110011101111111111111111111101111101101
120001222121111122211121111111110111111111111111111110111111a0111100122212022211202220022222222a1012020211101101111011011000111111111111111111111010111111111111
022222002111122020202120001111111011101011111111011101100001a1111100122222022022020222222212222b2200111211111111111111111111010101110111101111000111101111111100
102121021112222212020002210110111011111101111110101111111011a1111110111020221222221222012020220b1202022211111111111011111111110111011101110011110111011111101111
010210111222111222211122211110111111110111101101111111011111a1111101112022022002202022222222222b2121212011101111111110111111110100111111100111110111011111111111
211222221211101212121222111111111111111100111011111111101011a1101111000112222222222112220122222b2220221111110111011110101111110111111111111101110111100111110101
121121121011122221121221110011011011111101111110110111011011a1111112202122102221200222222202222b2212211101111111011011111011010111010110100101011011111011111111
121101112212222210111121211111110011011111111111110111111111a1001112210211220222200022110202222b2222201211111011111110111011111110110111111111111011111111111111
112100221211201211120100111111111111111111111111110111110111a1111112211022122002221122222222220b2222212211011101110100101011110111111111100110011111110101100111
211120211212201222221212211110111111111110111111011111111110a1111101220202222020122202020222202b2202022110111010111111011101100101111000111111111110111011111011
101110222012212212211220210111111111101011111111110100011111a1111111122222222222221220022222221a0022222111111111111111111111011011110111101011110100111110101010
112110022112122022110221211111110110000111111111011111111111a1011110121220222222222202220101220b0012212211110011001111110110111001010111010101111011011111111110
111120221020001121211111111111111111101100011111101110111110a1011111101222012220222212211212222a2212212101111111111110110111111111111100010111111111111111111111
120222102001222201212212101111001111111100111110110011011110a1010112122202120222220222222022220b2211210010111111111101110111101101110011000111111111100101011001
010000111001221210212120111111111111111111001001111111111110a1111011022110222201222212200222222b2220010210111101011110111110111001111111111100111111111110111001
020122111202011012111202111011001111101011110111111111111101a1111100122222220222222222221222110abbabbbabaaaaaaaaaaaaaaaaaaaaaaaaaaaaaaaa110101110111111111111110
212122020020102210122122211111111101101011111111101111111111a11011112212102220222220222222222020222222101101111011111111111111111101111a010111101111111111111111
021211110111110221200002201101110111011011110111110111111101a11111121221002221222202022122222221222212111101111111111111011111111100111a011101111111011010100111
220202112211200110000111111110111111011110110111100111011101a00101102222222022222212122220212020222202121111111111011010011111111001011a001111111111110111101111
221100122120220002211211111110110111111111111111011101111111a11011102221102222222021222222202222021022120001111110100111011111111111111a111111111011111011111111
111112212221120012222011201101111111111111111111111111111111a11010112022222012221221002202220222221212221011111101111011111111100111110a111111111111111011111111
200122122122211011101022211111111101111111110011111110111101a10111120101222222222000212222220022222121111111111110111110111011010001111a110110111111110111101101
022222120122222212212121011011001111111011111110111011111111a11111101110221002121222221222212222202221000111111110111101110110111111011a110011100110111011111101
111220111211120201022010011111101101101010111111111101110110a00011101221022220222222012222220122222211110110011010111111111011001011111a111111000111011110111100
abbbabbbbaaaabbbbaabbaaabaaaaaaaaaaaaaaaa0001111101110101101a11111112221122202122022122222222102202221021110111101111111111010110110011a111001101111111110101101
1202220121021121222211121110110111011111a0111110100110110111a11111001022210222212002200202120222111111011111110011010111011010111011111a101101010011111101111111
2212012222012121021122010101010011111111a1111111100111111100a11111101101011210122221101121112222121121121111110111011111111011111111111a111110111101111010111011
2011002122220001120012122111111110111111a1110101111111111111a11011111111111022202122202201210200222122021011111001111110011111110111111a110110101110101111111110
1011111111111010111111110111001011111101a0111111111111100011a11111111101110211121221221102221222121211111111110111011111111111111111100a001011111111111111101111
1111100111001011011111110011111111111111a1111101111111111111a11110101011111101101111011111111011011111111111111111111111111111011111101a001101111011111111101011
1101101111111100110011111011111110010001a1111111111100110111a01100111111111111001001001011010111101110111001121221212211002110210220200a020011111111110110111111
1101110111111011111111101101001100110001a1110101111111111111a11111111011101101111110111011111111110100110111111212120122112222111220110b111211111100101111110111
0111110100111111111111111101011100110010a1101111111111111111a10111001011011111111001111111111111101101110111022110011122112211211021112b121201111111100111111111
1110001111110110111111010111111110111111a1101010011111111101a11110111011011101011111101111001111111111010111112102101201121210010012022a121201111101111111111111
1111111111111111110111110111110111111111a1111111111111111111a10011111111110111110011101111111011111111000111100111111221111012001112222b111211111111011110110011
1001111111110100101001111111111111111111a1111111100111001001a11011111111111111011111111111011111011101111110111222122111121200111200221a111011101011011011101110
1111000111101011111111111111101101000111a1100110101111100111a11111010101101111111110110011111101111111011001121021202122011212122120002b221011110011110001111011
1010111111011011110011011111101111111111a1111101011111101111a11111111110110111101111111111111111011011011011101012201220212021122121222b221211110110111111101011
1011110110110111111011111110111000011010a1011111111111111111a11111111111111111011111011111011111111101011111112212111211200201222022020a121011111011010011111011
1011101111111111111111111111111011101111a1111111111111011101a10011111111011111101111011101111100111111100011122011012121220101201221012a112201110110111111011111
1101011110110010110110100111111111111111a1111101110010111101a11111110110111101111101111111110111111101101011121112212211112112021222102b012100111111110001111111
1111111111111110111111111111101111111101a1011111111111010111a11111011101111111110001111010011011111011111011102202101122212112010211212a111111011111001111111101
1111111110110111111011011111111111110001a1110101111011001111a00111011111101111101110111101011111111111111111101121201122202012221212202a222101011001000111110110
1101111100111101111111011111111111011111a1011111111101110110a01111111111110111011111011111111110011111101111102021211111010022102210112b121110101011110111111111
1110011011111111111001111111111111010011a1111111111111111110a01001111110111011100011111111110111111011010011111101221122111221110021122a100211111110011111111111
0111010111111110110110111110101110111111a1101101011010111110a11111100011111111111110111111111110110011111111102012211011012122221112111a011111101101111110111110
1111001111010101111101111101111010111101a1111101101110111110a11111111111011110111111110111111111111001111111111121210210122202221002222b120111111101111111010111
1111111110111111011101011001010101101011a1101111110011101111a11100111111110101110110111110001111111111111011111120122222122022101212110a120210111111110111011101
1101111111110011101111100111111111110111a1111110011110111100a11111111011111101110111111001110011111111011111111222202112001121101022212b002111110011111011111111
1111010110111111010111111011011111111101a1110111111011100101a11111101111100111111101111101111011111011110111110101210111102211112010221b021011111011111111110111
1111111111110110111110111011001111110101a1011111110100011111a11011111111101111011111111101011111111111111101012200212210121122121111122a022111111011011111111100
0111111111111110100111111011111101111111a1001111100110111111a11101111100111101110101111111111111011110111111111012212210002211222211112a211101011011111110011111
1101111011111111011111111111111110011101a1111111101111111111a00110111111111010011001111011101111111011111101121120021101122121121222122b121111111111111111111110
aaaaaaaaaaaaaaaaaaaaa1110011001111100111a1011011111101111110a11111101110111101111111101001111111101111010011112121112212122201101020202b211111111001110111101111
11011101111111101111a1001101101111100100a1110111111111111011a11111111111111011111111110011101011111111110111121111012121212002022211022b102111101111110011011111
11101111001011011110a1111111101111011111a1111110001111110111a10101110111011111111111111111100111111011111111121202210121201102112201121b000111111111100000111111
11111111011111111110a0011101011111111011a0111100111110111110a11101111111111110100101001111010011111110011111111211112021111102212221112a201111111110111111111011
11111110111111011111a1111111111111011111a1001011011111111111a10111110111111110101110111111110111111111101010110201111011002110121111221b020011111111111110111111
11111111111111111010a1011110110111101111a0111111111111110111a11110111110111111111111111000111111110111111111102110112210201020101112102b122111101111101110101111
01111111111111011111a1111101111111010111a0011011110111111111a11111111110111111111101111111111111111011111111112111000201222211122221011a221211011110011111111111
11111111111011011111a0011111110101111111a1011111011111101111a10111011110111101111001111101111110111111111111111202121012201011221112222a211201111101111111111110
01111111101101111011a1110101111111111111a1111011101011011111a11100011111111111101100011110101111110111110010101111011111111111011111101a111111011110111111101111
10011011111111111101a1111011111110111110a1101101111111111111a11111111111111001111101111101111111111111110101111101101011111110100001011a111110111011111111111111
10111111111111001111a1110011111100110111a1111110011111111111a11111111111100011110011110011111110111011111011111100011111111111111101011a111111111111100110111110
11111111111101111001a1111111100111001100aaaaaaaaaaaaaaaaaaaaa01111111101101111111101110011111101101111101111111111111111101111101111111a111111101011111100011111
11111111110001101011a111101011111111111101111111111111111111101111011010111111111110101110110101111111111111111011111111111111011111111a011111110111101110111011
11011111110111011101a111111111111111111111111101111010111010111110111111011011110111111111111011111101101101101101111111101111101111001a110101111111111111111110
11101111000011111111a111110110111110101111101010101111101111111011100110111101111111110101111111111101110011100100111111101011101011111a111111111100111011011100
11011111111110111101a111111101101111111111111110011111101111010111111001111001011111111111010111011111111100111111001111010011111011111a111101111111111111111011
11111111111111101011a011101111111111101110111111111100111011111111111011010101110101110111110101111111111011100111011111111001011111111a011011111010110010111111
11111111111111101110a111111110111110101111111111111111011100110110011111111111101111110001111111111110101110111011111101111111110100111a111111011001011011111100
11011001100111110111a111000111111111111101111111101011110111111110111110111101111011111111110111011111111110111101011111010111111110011a111110111111111111110000
11111110101111101010a011111111101111101111010111111111110011111111111111101111011011101011111100111001011111010011111111111100110110110a111111110011111110111110
aaaaaaaaaaaaaaaaaaaaa111111111111111101111011111011101110011111001111111101111111011111101010111111100111111110101101001101111101101111a111110001101101111111001
a01011011111111111aaaaaaaaaaaaaaaaaaaaa011111110001110101010011110111111111100111111111110111110111111101111111111111111110001111111111a111011011111111111111111
a11011110111111111a1111111001111111101a011100111111111111111111110111111011111110101111111111100110111101011111111110111011111111110111a011111110111111111011101
a10111001110110111a1111011111110110111a010111011111111111121110201112112212122211110211111011111101110110111111110010101110011110001111a111111111101111010110001
a11111110110111111a0111111111110110100a101111111111110102122201021211120102211212021200111111010001111110101011110101011111111111111111a110111111111111111111011
a11111111101111001a0111110111110011011a111111111111101112102001122212212111222122001211111111111111011101111110000222121221012111111201b010111111101001110011101
a11001110111111111a1001111100111001111a110111111111111112221201212021201220022212222121110011011011110011110121022201201222120111210121a011210101111111111011111
a01111111111111111a1011110011111111111a111111111111111110221110220202022112120211121212011011110111111011111111222121211111121012010221b111101101111111111011111
a01111111111011101a1011111111011100011a111111110111000012011222202100021020110022011111111011110110111111101112011220221212022112221010b111011010011111111111010
a10011111111111111a1111101101011111111a111101111111111111121121010120122111222212112012110110111111111111110120012121212101202010211212a202111111111111101111011
a11101010111111011a1111101011111110101a110110110111110112101221112101221002110100120111111111111111101011111112200202100210122222210121a120211011011110111110111
a10011111110111111a1101111010111111111a111111011111101110002112102110221122222212102011011011110110111111110121121112111221110111120222a010011111110110111111111
a11111111011111110a0011111110001101111a000101111101111111221002210201121002001222112111111110101111110111001112000022221101110202122211b222111111111111111111111
a11111111111111101a1111101111001111110a111111101111111111121200010222121212020212111011111110111111111111110121011022122122111122211222a101201100011110011111111
a11011111111110011a1111111111111111101a101111110101111100222012201221201222122121212121111111111111111111110121022211121022122211001212a211110111111111111011111
a11011101111100111a1001011111011111101a110111111110111111212112101111121111121211211021100111111111111111111011011120202022222020222011b122010101101110111011101
a00011101101101111a1111111100111111011a111111111010011112222120221001111102212121202111111111111111011000101100121222222211212211212222a120011101000111101101101
a10011011111111111a1101111111111110011a011011110100111012101221112210122000021221110211110111000011111101111011221201102222022012210001a000111110101111111111011
a10111111111111010a1011111011110111111a101111110111110111220221121101221110110222121210011101111111111111110112210112112122101112222112b112010010111101101111111
a11111110111011111a1111111111111111111a111111111111111110212012210121221210211202112110111111011011110011010112021011212222120221112100b211011111111011101111111
a11111111110111111a1111111011111011110a111001001111011111111201212222210012222112211211101111010011111000111011121020111210202011011122b102110101111111111101111
a11011011111111111a1111111110111011110a101111110111111111111010110011122210221111000020011110111111011110111121112220112021112112211121a210211111111011111011111
a11111101111011100a1111111111011111011a111101110111110110210122121222022102011221102222011111111010111011110112101112222001212011112221bbbaaaaaaaaaaaaaaaaaaaaaa
a11110111111101010a1111111111111101111a1111110000111010120221201112202011112022120111201111111001011001111011112220201200011111221021212022211000111111111111011
a11111111011100111a1111111111111111111a1011111111111110112022111222111102120101222110221001111111001111110111122112220222211011011211021222010111111111111101111
a01111011111111111a0111111111110111110a1011010011110110102120220221202111222021222111001111101110100101111111122001222100221122211222022211101221101220220221111
a11111111111011101a1011110111110111101a1111101111100100111202120211201221022221122102211111110111111011101101112102111211210222022201220220012200111121220221111
a11110111101110111a1011111101111111111a1111111100111101121110211012211112111120211110110111111111111011011111210222212112221222222202212220222202100122110120110
a11111111111111111a1011001111011111111a1001101011111111121111010212201211212202202222201111110001111110101111101111121111122122222022222121221102100111211021111
a11110011111101111a1011111011101011101a1111111100110110102122211202200110212020121120121111111111110111101101120102021222111022222222222021120112101120012111111
a11001111111111001a1111111111101111101a0011001111111111121121202221212121112120122121121011001000101101111111211221201211222122122220200102212121021211111101111
a10111111011111111a0111111110101111111a1111011101111001122211122101022121020212021102111111111111011101001011021100222122012221212202222210121120202122220111101
a11111111101101111a1111111110111111011a0110111011101001100211222212211221101212102122210111011111111111101101211221200012112122021222200022110211121222121100110
a11100111111111111a1111111110100000101a0111111111111111121111022011120122202222120011201111011110110111100101110112200212221102212011220122222021222110221121011
a11101000111100010a1011111101111111100a1111111011001111111111101110011111111111101111111101100010010111111101021211102110122000100202202112020211121211212201111
a11111111111111111a1111111101111111111a1111111111111101111111110111111011011111111111101110111101111011101111211012022110121122222222021121122002112011201221111
a01111111111111111a1111111110111011111a1111001111111111101110101110111011111110111111101001111101101111101110111111101111111122222102222202111211211221120121111
a00011101011111111a1011011110111111111a1111111111111111110110111111111101011111111111111111111111110101111111111111111101111112222112211112212111211222112221010
a11111111111011011a1011101011110110111a1111111111101111101111110001111011111111111111111101011101110101110110111111111111011011002102221122112111012102222111111
a01111101111111111a1111111101101101111a0111111111011110001111111101111010111111111111110001110011111111101000110111111001111100212122201221121210221212121221110
a01001011111111100a1111110011101011111a0111110011111001111011111111111111100110111111011110101011111111111110110111111010111120212112221222000002120200112220111
a01110111101111111a0110011111011111111a1111111111111111111011111011111111011010111101111111111111101111011111111101111101111100212022012111120211111221101001111