136 2
5 3
148 77
86 99
118 49
42 19
33 49
108 115
15 97
147 86
111a110011110111001111111111111111110111110111011111111111101111101011011000110110111111111011111111110110110111111011111011111111111a11111011101111111111111110
111a111011011111111111101101100111111111101111101011011110111111111011011111100111111111110110111101101111111111111110111101111110111a11111111001111011111011111
110a011111011101111111110111100110110011111100110111011111011111110111110101111111111111111111101111111111001111111111111111101011111a11111111111011111110111111
110a110010110000110111111111111010011111111111111111111111111111101111111111110111001111101111101111111000111011101111011010111111111a11011111111110110101111111
111a111111111111111111111111101011102021012012022102012011011111111111111011111111101111110101111111101111011111011110110101111111111a01111111011110111111101001
011a110111111101110101111101222121111202012020121110111222111111111011110111111001111011111111111111111111111111001111111111111111111a11011111101100100111111111
101a111001101111111111011011110011021122222222100101000211111111101100111111111100011011101110111111111111111010101101111111111010110a11111111111101110011011111
110a110111010011111111110111212100212112001200122100221010111110111101111111111101111111111011111110110001111111001101111011011011111a10111111011111111111111011
111a111101100101110001111110112022112212122011112211211122111111011101111111111011111111110110110111111010100111111101111111101111100a11011111111111111100111101
111a011101011111110101111111211012222122221010110222112021100111111100111011111110111110011011111110011111010100111111111110111111111a00111111011101100010011111
111a111110111111101101111102121222200201121121210111121222111111110111111111111111111110011111111111111111011110111111100111111011011a11111110101101100111111011
010a110101111111110111011011012012020221001122201120022212111111010011111111110111110010111111111111111111001100110110111111111111111a11110110101101101111111111
101a110111011110011110111112221212111122200022120102201212111111111101111111111111111111101111111011111011111010011111101111110111101a11111111111101111111111111
111a111111110111111111011101212211210011101121121111121221111111111000110010111011111101111110111111101011011111111111110101101111111a11111110110101011101111110
111a101111101111111101101112011211121010102210011101122122111111011110111110110111110011111111101111111110011111011001111111111111110a01101111111011111110111111
111a111011101110110110111112010102101111212102110222210222011101111101110101101111011111101111010111111011111011111110111011101111111a00110111111111101111110111
001a110111101110110111111111011210022201000111222122111211010111011111111011101111011011010011111101100101111011111101110111111111111a11111111111111111101111111
111a111111111011101100111112211122220222210222222222012120110111111111011111011111111010111011101100111110110011111111111011111011100a10011111100100110111111111
111a111111101111111111011101111120111211010122121002220212111011111110111111011101011101111110111110111011110001111110011111110111100a01110110111011011111011101
111a11111110011111111111111201202bbbbbabbbbbabbabbaaaaaabaaaaaaaaaaaaaaaaaaaaaaaaaaaaaaaaaaaaaaaaaaaaaaaaaaaaaaaaaaaaaaaaaaaaaaaaaaaaa11111111101111000111111111
111a11110011111101110011110212000a202222111121111122222021101111110111111011011111111110111111011110111011111111111101101111111010111101111111111011011110011111
010a11110111100011011101011111112a111110211102221212102012011101011111010100111111111111111111111001111111111101011011010111111111011011111110111111111111111111
101a11101111101111111111111010212b220211220011211212002111111111111011111111111011111110110111110111101101111111111111111111001110110100111110100111111111101111
111a11111111110001111101011110211a101121112212101120110101111110111111010111110011111111110111100011111111111110111111111111001011011111101011111110111011001111
111a11111011111011111111111122212a220020212212012120122221111101110011111010111011011010111111111111110001111011111101011110111111111101111110111101111111100111
111a11011100101111111111011122201a000220121221112112220112111111110111010111011111010111111011111110111111111111111010111010011111111110111111101101111110110010
101a00111011111101111101111201111a120010010020011122222212110101111110111111011111011001110110111101111111011111101110111110111011101111101011111010111101111110
110a11100111111111111111101211111a102222111122011121222111111111111111101111111111101011011111111111101011110111111111010111101111110111111111110111111111001010
111a11110111111111101101010102020b122211021211120112122212111111111011111011100101111111110111111111111010110111011101100001011100111011111111100011011111111111
110a11101011100111110111111222101a212012102122122012222222110110110101010011111110111011111110111101111010111111110101111011111111101111111111111010101111111111
110a11101101111011111101100121222a121111121201221110202221111111111111011110011100111011110111101011101111101111111101010101111111111110011111111110001101111111
111a11111010110111111111111102210b121212212121011121120021111100110111011011111111101111110101110111111111111101111011111111111100111011111110110111011111111110
111a11111110111111001111011111011b222122200200221202201012111111011111110110100010111111111111111111101011111110111111111111111101111111111110111111111000111101
001a11101001111110111101111212221a211222002201112222221221111111111111100111011101001011111111111111110111011011011101100011101101111111111011111111111100011101
111a01111111101111212222212221221b001222011222220021121122111110111111111111011111110000110011111110111221212122012121202011201011212111111111111111111000101111
011a11111110111110111101211210121b110112202012111111111111001101010011110101011011111111111111111111111220211112112012100121112112222211111110111111101101111111
011a10111001011011221210120210110b010201222221122111011011101011111101111101111110111010110110111111111111021010010012212221122222110011111011111111111111111111
011a11010111111111021120221212222a020221222021211111010111111011111110111110011111111111110111111110011210201122210121021101122121210111011111111011011111101101
111a11011101110111110112101211110a110012021011102111001001111110111111111101110111111011101111011111111100121212222122221200122120222211101011111100111111011001
101a11011000101011121221122022212b211212220222221001010011011101111111011011111111111001111011111010101211222112111022001101011121000211111110111101110101111001
110a10111011111111211122211011112b212222202120101110111111110111111111001111111111110111101101001111101121101101211210011110100222120111111111111011010101101111
111a11111011111110212212221202222a122101212102221111010111011111111010111111110111001101110011110111111112121012102122222021222112201201101101011111100110111111
111a01111111011011022112110200211b000120010111222011111111111111110001111111111101111110111110111111100122122221011111110021222111100010111111011111111111111111
111a10111111101111201211220210200a012122212211100101111101110101111101110110111101111111011011111011101102220011121211202112121212012100111001101111010111111111
111a11111011111100002022212221222b222101221120102110111111111010111111101111111110111110100111111011111122101220210220111001122211202210001111111101111110110111
011a11011111111100212221120211210a220211122211121011111110110111111011111010111110101111100111111011111001211212212122012220102212021201110110111110111111101111
110a10001111110011201211221211011b222122211200200111111111111111011101111111010111000111000111100111111222010112212222221012122012012111101111001111111111111111
111a11110001101111112000221202012b221121111102212011111111100111111110111111111011011111111111011111111012112112201211221101222111122111111011111111101000011011
111a11111111101110121111001222112b212222111121001001111111111101111011111011110101111001101101011111111222021202112112212122122211101011110111111101111011111111
110a11100011101111112211222012221b210102020122110101101101111111011111111111011111010011101111110111100021122012212122100011210202202201111111010111100111111111
111a11111010111010110121111121110a111221121121210111111111111111111011011110101111110111001111111100110010220200112211112202022111221210101110111111101100111111
111a00100111111111101222102121102b220211221021000110111101111101101111101011100110111111101111101101111210122020212121021111202202112011111101110111111011111110
011a11111011100111111201112101001a022121221110221111111110111110111101111111110111110110111111101100111221122012022121110011221222222211111111111110011101101011
111a01111010110111202022210121112b211202122121120111111110111111110101111010111011111100011111101111011221211200112110121212122111011201111110011111111111110110
111a01111111011111111012102212211b111010122120102111001011101111111011111111111111111011101111011111111202120021212102222201112121021210110011100111111111110111
111a11111111101111010202110122111b122200211201111111111001111110111111011110111011111111110110010011111122111201222221101110211121020111101000110011110101111011
101a11111111110111220110112212110a012121112221121111011100011101111111110111111110010111101110111111111221102121210222221201202122110111111011111111011110111111
100a11110101110111222111000100220a221212010202222111111111111111111111111111111111111101011111100101011121120201212200121121211002212111111101111111110111111111
011a10111111111110221102121211112a122221121221111111111011011111111111011111101011011111110111111111111021221000101202220201122101120000010110111111101111011101
111a11111111111111121221120101221a20010210022202211111111111111110111aaaaaaaaaaaaaaaaaaaaaaaaaaaaaaaaaaaababaaababbabaaabaababbabbaaaaaaaaaaaaaaaaaaaa1010111111
101a11110011110111222211221120120a20122212112021211011111110111111011a0101110111111011101111111111011111122212102210121210221111221020010111111111111a1111111111
111a11101111111111201020110002202b22201021122211201111111111100011010a1101110101111110111101110111111002011212212022222021022012222101011111101011011a1111111111
111a11001111001100022111212202220a21222110100111001111011110111111111a1111111001111011110110111111101111111221220221212100210222101120122211102111220a0110111210
101a11111111111111120211222122201b12012010221212211111101101111111110a1111111111110101111111110111101102210222222202011110011120220022102011212122221a1211102121
001a11110011110011011110121212222a12202122202120111101111111111111111a1111011101111111110111111110000011121201122112202211222011202202221112222212211a2112101212
011a11110101111111101101011010111a11111111110101011010111111111101111a1110111111111111111110111111111011011011111011111001111101111111110211120221011a0220112211
011a11111111101111111111110110111a11111111110100001110101111110111111a1110111111111010111111111111111101111110111101111011101011111002121222112022011b0122111102
111a01111101101111110111110111111a10000111111111111101111111001110111a1111101101110111111111111111111111100111101111001110101100111112022221222122220a1111021222
111a11111111111110011111111110100a11100111111111110111110111110111011a1111111111110011101111010101111101100111110110011011110011111101202110220111221a2110122211
111a11111101011111111000101001101a11110111111100111110111111110111111a1111011111111111011111111111100111001111001011111111101110111112211111112121211b1001212100
111a10011101111011000111111111101a11111101111111111001111111111111111a1101111111111101110101111111101111101111011110111111111011111101022222221222212a1121110001
110a11111101111111111110111111101a10111111101111111111010101101110111a1010010111111011111100010111111111111101101010110111100111101101021222201111012a2222222000
111a11101011111110111011011111111a11111111111111111111001111011101011a0110111110111111111101110111110111011101111111100101111011111002020222111212022b0222022220
111a11111101011111111111111001110a10110111111110011111111111101011111a1111001011011111101111101100110111110110101110111111011111101022222122211020222b2022020021
111a10111111010110011101111011001a11111111110111101001111100100111110a1111111111111111111111111101101111111111011000111111111101101112221120122120222a2212022002
111a11111111111110011111110111101a11111011111111110101111110111111111a1111110111111101111110111101111011110111101110101111111111111120202112102022122b2222220022
011a00101111111111111111110111111a11011111111101110111111111110011110a1011110011111111111110111111010100101110111111111111111111111112222201002212220b2222022122
111a11110111011111100100111101111a11110011110111110101111101101111100a1111110101111111110111111011111111111111110111111011111111111112121220222201120a2022022211
110a11111110011011011111110111111a11011110101011111111111110011111101a1111111111111110111001111111111111011001010111111111111110111122222221221221102b2221122220
111a111110111aaaaaaaaaaaaaaaaaaaaa11111111111010111100111011111111011a1111111101111101101aaaaaaaaaaaaaaaaaaaaaaaaaaaaaaaaaaaaaaaaa1122122122021220222a1222220010
101a111011011a1111011111111111111111101110101111101101111101101111111a1111111011111111111a111100111010111111010010011001000001111a0111011002021122201b2222012022
101a111101110a1011110111010111111001111111111011110100000011110111111a1101101011111101111a111111000111011111111111110110101111110a1122221220221222122b1222222211
110b022221002a1012012111102110111011111111111111111101111111110010011a1111110111011011111a001111101110011100111111110011111111101a1102122220212022222b2220122012
100a211222222b2011021202001222010011111111111111111011000011111011111a1011111101111111001a111111110011101111111101111111111111101a1021222222212222202b2222220222
102b211202212a2022011110120112100111111111010111011111111111011111111a1110200211022101012a012120221010111111110111111111011101010a1111000211012212122b2200021222
120b211022112b1221112221012211110100111110101111011110110101111110111a1122211101022020012a202020212122111101111111011101111101011a1110222212222120020b2220222011
120a112122111b0220222222222122011010110101111110111111111111101011010a1112011111212210221b221022221221100011101111111111111101110a1001202220221222220b2102222212
122a112212122a2112210220221211011101011101100101110011011111101001101a0101221121111111211b022022122121101010111111111110001111011a1102221220110202222b0102211222
010a211120121b0112221222112020211011010101111110110011101111111011111a1002222210101202201b100101112211111111111111111111111111110a0122222202220220022a1012122220
122a210110202b1111122202112102110011111110111111111111111111111111111a1020122021220202211a220011120220110100111111011111111111011a1112112212211222200b2001200222
212a022202211b2211220120121121011011011110100111111111111111101111101a1120112200201202101a221012101102001111111110011111111110111a1112122111202001011b2212202222
112b021212212a2122220210112212000111110110111011111111101111110010011a1212121210212010221a210222111121111111100111011111111011111a1110100112212220120b1022212201
021a211122111a1022221021012020011111111110111111110111111111111101111a0101220210211020011b120212210220001010111111011011101111111a1112202022122120122b1201020122
212b121220211a0122022201121110201011011111100111111101111111111111111a1121102200101102202a202201101102111111111110111111101111111a1121100112212121101b2211001021
102a122121122b2210121112201212110100110101111110111110111001101111110a0211211122202120122a112121021122111110111011101111111111101a1021202110112212212b0222110212
200b102101121b0001121012021122111111111110111011110010011111111111101a1120100210201022001a112122102222111101111111101011110101111a1112012021121221110a2210111200
222b020002111b1121001012111102011111101101111111001010101111111111101a1121110111221021112a112111120201011111110011111110010011111a1101200112222121221a2112122212
221a201211002b1121121222121112000111011111110111111111101110000011111a0111211110110122111b112211101120111110111100011111110111101a1100121111212111212b1012221111
222a010111111a0111222122200100211111111101011001111111111111111111111a1102121012120112222a110122012012011111111111111101101101111a1121212122121201221a2212212212
210b122101111b2012110112212121211101110111110111110110111111111111111a1112110121221120121b101222102112111111111110111111101011111a1121112212212120121b2222011120
012b112222110b0212201121022222211111010110111011110010111111101111110a1202221102211121022a122222122211110112220222220202211210111a1121211011121111001a1122110110
221a000102101b2221221200211022110111101111111111101111111101111111111a0211211120011211111b111212122220112110021012222210002111111a1120222002212222212b1001122122
212a001221111b1211122210102221100010111111100111111111111011101111111a1200222022200112211a211221212202112221222011122011011101111a1111111101011011111a1101100111
201b011222220b2110122210121202011111111101110111111011111110110111111a1222112111111121200a012010222001212012222122211022122211111a1011110111110001110a1111011111
022a010021001a1120202122121201110111111111110011111111100111110111011a1022121202102121122b021012202211021212110220021211122211111a0111111111111111010a1111101111
211b012122122b2120121112210222111111111110110111001111111111010111100a1221221011220110212b122122102222221122021222111220211211111a0011111101011111111a1100111100
102a200002122a2222200101122012011111111111110111111111110111111110111a1112112101122221201a212122012220221010012020222110110111011a1111111110101111011a0111011111
120a212221001b0202101122100210211111111001111111111001111111110111111a1112202212001201210b121020222210212121221120001101120101011a1111011111011110111a1111011111
111b221221101a2221102111222012211011111001111111111110111111111100111a1121011012012212102b120212222121122102122121111121211111111a1101001101011111111a1111111110
100b121122211a0122202012222002211111100111111111111101110111101111111a0020102221221120122a012221222210220202201201012012111201111a1111111111111111110a1111111001
100a201221202b1011120221211120111110110111111111111111111011001101110a1121021222112112222b020222202111200001122221002211221111111a1100011111111111011a1100111111
111b022221101a1110022120102111011001111111111011111111111011101111011a1102100110002220211a122022212212212222222110101111111211111a1111101110111111110a1111111100
110a110111112b1221222222100121100010111111111111011111110111101111111a1121222012202202111b101021021212212112112001112211200211110a1101000111011101001a1111101101
011a110111111a1110111011111111111110111111111111011011111100111111011a1101001200121101110b112212112222111222102121201211202101111a1110111011011110011a1010111011
100a110011111a0011110111110001101111111111111011111111010101010111111a1200210122121222111b212022222022102201211122200020122201101a1111111111011111110a0011111111
101a111111111a1111111111111101111111110101101111111111101111111100111a1111101111101111011a111101120222212221122200222221220011110a1110111110111101111a1101111110
111a110111111a1111111111111111100111111011110111101110111110111101111a1100110011111011111a111022111220211022212102221111111211111a1111101111111111110a1110011101
111a011111111a1110111101111011111101111111011111111111111111101011011a1111111100111111111a111110112112121010021210222201202201101a0111100011001111101a0111111011
111a111111111a1111011011111011111101011111100110111111011111110011101a1111111011100011110a111121112212112121102112201221011211111a1111110111111111111a1111111111
101a111010000a1111011111011111011111110011111111100111101110111111110a1111101010111111111a111120112121021222122000222002222201110a1010111101111101110a1111111001