104 5
0 88
18 35
13 67
144 87
63 76
137 81
150 102
79 68
58 83
01111110111101111111a1110110111111100111111011011111111111111111011110111111111011011110a0011111111011111111aaaaaaaaaaaaaaaaaaaaa0101111011111101111001111111101
11111111101011101101a1110011011111101101111111110111011111011111111111111111110111111011a110011111111010111110111111110111010111a1001111010001111110011111110110
01111011111111111111a0111100111111011111011111101111111100110111111100101111001111111101a111111111001111101101111111111111111011a1111111111111111111111111110111
01011111101111110111a1111101111011011111111101110111101101101111100101101111111111111111a111111100111011110111111110111111111111a1110011111111111110110111111110
11010011001101111111a1111111101110111111111111011111111111111011100111111111111101111011a011111101111110100110111111101110111110a1111101111111011100110111010111
11111111110111111001a1111111100101111011011011111011111010101011101111111111101101010111a011101111111100111110011111011011101111a0101011110100111111111111100111
11111111111111110110a0111111001111111110111011110111110111111111111111111110111011001110a111111110101110111101111111111111011110a1011001111111011111111110111101
11001111111110011111a1111111111111011110111101111111111111110111111110001111111110111111a011111111100011100111111110111110101010a1001111101110111111011111111111
11111101111001111101a1111100111111011011101111010111111111111101111101111010101111101111a111111001110101001101111111011011111011a1110110110111111111111111111110
11111111111111111111a1111111100111111111001011101111100110011110111101110111011111111111a111011111111010111111101011011111001111a1101111111111011111101111110110
11111110001111111111a1111111111111111111101111110110010111110111011100010011011101101111a101011111011110111011111011111111111100a1101010111111101111111101111101
10011101111111111111a1111111110111000111111110100101111100111011111111111110111011011011a111011110101101101111111110111110111111a0111110111011101110111100111010
11111111111110111111a1111111111111111111000111100111111011010111111111111101111011111111a101101111111111110110110111111111111111a1011111111111111111111001011111
11111111111111111111a1111111011101110011111110011111101110101101110011011111011101111111a011111111110011111111111111010101101111a1101011111111111101111110111101
11110111111101100101a1111111110101111110111111111011111111111111111011110011111011011101a111111111011101111011111111111111111111a1111110111011110111110111110111
11101110111101111111a1110011111111111111111111111111011011101111111101101110111110111101a111100011110111111111111101111111111111a1111111111000110110111111111111
11111110111111111101a1110110001111011111111011111110001111111111111110011010110111111111a111111000111111111111010001111111110101a1101011111111111111111111111101
11011110111101111111a1111111101101111111001110111011100111111111011011111111111001101111a111110110111110011111101111111111010111a1111111111111011110111111111111
11101110111111111111a1111110111110101011111010011111111101111110010111111011111111001111a110110111111011111111011111111111110011a1100111110110111111110011111111
10101110001101011111a1101110011111111111101011110110011100011110111111111111111111111110a111010111111111111010001111111100100111a1111111101101111111111101111110
10111012220021102221b2110211011200111111110101101110011010111011111110111101110100011111aaaaaaaaaaaaaaaaaaaaaaaaaaaaaaaaaaaaaaaaa1011111010011111110111100101100
11120100120221202221a2111210121110111111111001111101001111011110111101110011111101111111111110111111110111111111111111100111001111111101101111001110001111011111
10112211221202201122b2212222120220011100101010111111111001010110100111011111111111111110111001111111010111000011000111101111111111111111110110001111011011111111
11122222212211222220a1102211211212010111111011111111011110111111111111111101110111111101100110100111111111111110111101101110111111011111111111111011111111111001
11122120211112200111b1211011201212011110100101111111111010111011111110101110110010101011011111111111101110110111010110111111111111100011011111101110111111000111
11011111022111112211a1102221211212111101111011010111111011011011111110011111001111111111111111111111101011111110101101111111111011111111101110110101101111111111
11101220021111011121b2111212022121111111000111011111101110011011101110111101111101111110100111111111110111101110101111110011110111011111101110111111101111110111
10102112022212111122a1120211122220111111111110111110111011111111011111111111101001111011001111011111111111011011110111110111111101110111111111000111111001111110
01100211212122221212b2211211212022100111101111110111111110111111111111111110101111111111101111111111111111111110110111111111011111111100111111101111101101101111
11102201210021202111b1121220212022111111111011101111111111100111101111111110111111011110111101111111101111101110101101111111000111101110111111010110011010111100
00112012121101111202b1212202112211010111111111011111111111111010111111100111111111111111011101111011111111111001011111111111101110111101111111110110111111111111
11121222112021221022a2112020201201101111101111110111110101111110111111111110111111110010111111100111111111111111111011111101011010110111111001110101110111111111
11012211011120101102b2202202110200111010111111011111111110111101111100101101101101110101100011111101110101111100101111111111110111111101111111011110110111111111
11122112012202121121b1222221212212101111101101111101011111011001111111101011001111111111110111111011111111111001110111111100111111111111101111101110111101111111
11111001200220100122a0202121102200101111011101001101100011010011111110011011111101010111111111010111111111111111111110011110111011111111001111111011101111111111
10120201212122001011b1121220121022111111011111111111101111111111111111010111111111111111111101111111111100111111101111001011111011111100111111111111111111111111
11111111101220022220a0221122111201110111111111110111111111111110111110111111101111111101011111110111110111101110111111111111111111111111111111111101111111110011
10021111211100120222a2110122022121111111011111111111101110111111111111111110111111111110101111111111011110111111111111111001101111011010111111111011011111111010
11122221210021121111b2221120220211111111011011101111101011111101011101001111111011111011111110110111101111110111011110100111111111111110001111010101111111101111
11112121101112222201a1221202201012111100111101111111000111101111111111011011101111111111111111111111111111010001101011110111110110111111101aaaaaaaaaaaaaaaaaaaaa
11122212212101221112b0020212202112111111101111011111111011010100101111101111111111110101111101110111111111111111110100101001111110111010111a10110110101111101110
11022122111220221111a1212202221110111111011111111110111111111111111010111111001111101111111110100111111111110111111101110111111101111111111a11010001011111111111
00110212112202121222b2020221121212011110111111101111111110111011111110010111101110111101111101111111101111111101011011111110011111011101110a01111111001011010011
11122122100211122012b1222022012112001111101111001010001111101011011111111101110110111011111001111010111111111110111110101111111110111111101a11111110111111111111
11111210122121110002b1012212122221111111111101101111111111101111111111011110111011111110101111011101011011101111111101100111111111111010101a11111110111111111010
10101111012221212010a2222212111222111111111111011000111111110101111101111111111111111110111111111110111111101111111111111110111101011011111a11110111110101011111
11121011012212111022b2200122022200111111011110110101111111001100111111110111111111101111111011111111111101011111101111010111111101101111110a10100111111111111010
10120001212202221111b2102122202111110010111111110111111111101011011011111101011110110011111110111111011111111111110111111111011110111111111a11111111111011011110
11111221121212110221b0022201001222111011110011011111011011101011011111111111101111111111110011111111111101111111101111000111111011110111010a11111111111101110110
10122202110100110121b2122112021200111011111100011111101111111110011111111111010011111111011111111101111111111111111110001111111111100101101a11010101110111110011
11122201212210221121a2210211122002111100011110101110010111111011111010111001111101111011011011101111111110111011101111011111111110111111111a11111011100101111110
10111111111111111101a1100101111110110111111001111111111011110011011111111111111110011011011111111111110111111111111111101110011101111111111a01111111111111110111
12221210122022012210a2121102211111111111111111111111110111111101111111111101011111110011011111001111111111001111101101111111111111111111111a11111111011111111110
21101112212111221102b2112001101110101111111111101111110011111101120211220222200121210212222120211111010111111111111101111110011111111111111a11111111100101001111
21112212111212111220a2202200011011111010001111111111111111101111211011101221120111011211100210011110010111110111111000111110111111111111111a00111110011110100011
21212210222221011101b2211121211111101111100111011101110111111111122222222101222122212121212220211110011111111111011110111011011111101111111a11111011101111110111
20101210012120110122b2022221110110111001110110111111111110111111121211211002110102112011122112011111111011010111111101111100110111011100011a11110111111110101111
12110020211222102222b2222222210111111011111011111101111101111111211222211212211120222120222211111111010111111101101111111110111111011111011a10111011111111000111
12111111120021101212a1121001211111111111111101101111111111111111212202121122112022122122011022111011111101111111001111111111111111111101110a11111001101111101111
22122202101220112210a1022111110110001111011111110101011110010110122222212212020021112120012122211111110100111110010100101111111111111110111aaaaaaaaaaaaaaaaaaaaa
11210221212011120121bbbaaaaabaaaaaaaaaaaaaaaaaaaaaaaaaaaaaaaa11002212212121001212122121201011021101101111101111101111011101111010111111111100110010111111110111a
122222111222211221011022202200111111011111110111121001110111b21200212010112202101111222112220121111111111111011011111101111111111101111111011101111111011110111a
100122101110020212221102202210111110011100011101011122211122b21022012202222220210021222211221101101111111110011111111101111111101111110111110101011101101101111a
100112000222120111122211011221111101111001110110112221212112a21120012220100000111221212102110001110011111111111111111011111111110111011111110111111111001101011a
110220211121011022211111110221001110111111111011021101011110b21112001022111122202220101202012221101111111111111101111110011111111011101111100111111111111011111a
020212122122210210120112211201111010111111111111212021021120a21122200210222212021122012102111221111101111111111111101111111011001111111111111011111111101101011a
120222100122210120201010220101111111001111011111111121221120a01200120121222211002112011221202121111111101111111111011101110210122122110112111122222101210011111a
112112122111221212112212112221011111101110110100112122101021b11022222222202222012001212121120121111111011111111100111111111121122211101211111111000201111111011a
110111222221110101110110222121111111110011120121122122020200b22222220200222212221202112222220121101111101111111111111111012011210022201112002101111022201101011a
220200020220022021221020212001111111111011022222022000122212b22222212221122222212112001121011111111111111100101011111111111212121122121002212001210200111111011a
211222021110121001122200221101011111101110101101222110101222b11222222022202222111112222122212121101111101111011101111111112122112120021222012221021211110111111a
121210212221021221111202012221111101111100012021210202221010b12202222212202222221110122021211111111011101110101011011110101201111112210102111022110210021101111a
122220112121221122110220101111000111110101111110220110212210a12220200022220002120221112101221121110111011101111101111111002211011220202212122222021221222121111a
111221111212121222020111120021101101111111000222212222222222b10002222012221020211121022211201121011110111111111110101101111102121021201022012120222212120221211a
122222222210202212112110111221101111111111111102222222212222b21002122202102022212110222111012121110111100110101111111111010002200122121122211222220212222011100b
212202122110121011112122101210011110010111122201222222212222b21022221122222222211121102222100211111010110101111011110110100022120212122222022222022022212212200b
221221202012202122222220121221111101111111101022101002112121b22222222222202200222002201110100010111111111111101101111110011222221222222000202122021022120202222a
111022202220110210002101100201111011110011110202222222221222a22002222022202212211220121220122211111101110111011111111111010102012222122010221102220222222111111a
212111221201012102121002012101111111111011110010222002022021b22222222022221102002021112111212101111011111111111001111101012220211220211221200222222120022110212b
022121101121221001022210121011100100011110122102112122210120b11122222222202122001221120210201221000111111100111011110111110202220222211201222212022212220212102a
211122221221111211102211112111011111111101121122100212220211a22122002222220022221212022211210220001111001111111111101110112122220222122220020220222022222221102b
122122112211122102211111022121111110111111012221011202111201b21221102222221022212211112002212111110010111110111100011111012110112110212220221112221122221222220a
002222110111222012211101101221011101111110111010221221222210a20211212222202202112002111111121211001101111111111110011111102101102201221112212202222212202112110a
111111011101111111111111111111111101111111011201122202222201b12022222201012221212221111011111120010010101101101111111111101121021220201222121120212220221112201b
011101111111111110111111101111110111111110010211220101222202b22210222112022212211101111111111101111011111111111111111110111011212221202120010222202122021121102b
111101111111111111101101111110111111111100111211021221022222b21220210212222200011100111111101111111011111111101100111111112212112222021020212222222021222220212a
110110111111111101111111111111100111111110110202222202112222b22220022022221222211110011111011111001011101101111101110110101121210012212222121120022022222110020b
101111110111111010111110111011011001111111102201212101221222a22110122120221101211110111111011110111110011111011111110111112221222122222220202220222010222021222b
101101111101111100111111010110101111101111112011222221000002b22220222211220122110010111110000010101111101011111111110111110211101122222222220022222222220220002a
111110111111110101111111111111111111111111102122220212112202b00020002202222122110111111110101101111100111111111001011111111122101020220222222212221222222222201b
011101011111111111011111111111110101111111022220110210221112a02202120021201101211111111111111111111111111111110110111110011111122212120222222222022222222212212a
110111000111101110111110111101101110011111111120200002222021a22101222022010222101111111111111111111111111100111111111101111112100222201022202202222002222102202b
111111001111111111111101111011111101101111101110100121101100b21222212111120101101100110110011011011011110101111111111101101122112102022221222222202210222112220b
111100111011111111111011110111111111011111110010102202101112a12022211122021011101111011101000111111100111111111101011010111211220002122222220202220222022211122b
111111111111100111111010111111111101111100010022201002012112b12212211112211110110110111111001010111100101010111111111111112011111222111220222122222220022120102a
101111111110011111111111110110001111111110021121112012121121a00112210121121110110111111101011111001111110111111110111110110102110022122202122222221222202022210a
110111111111111110111111111001011001101111120000012101022220a20122112101120110111100101110101101111011111111111110111111112011201022120222222212022212220000221b
011110111011111111011101111111110011111111120121020102020221a21222110222120110111111011111010111111111111111111001111111011111001111112202122220220222022210222a
010111111111111111011111110111111011111111111121212111202201a21101212112121111101101110110111111111011111110110001001111111010110122122222222222200111021122122b
011101101110001111011100111011011001101111111111111111111111a01110111111110111110110101101111111011111111111101110111110111011111222121222222122022202200000022b
aaaaaaaaaaaaaaaaaaaaaaaaaaaaaaaaaaaaaaaaaaaaaaaaaaaaaaaaaaaaa10101111111111011111111110111111110111111111110111111101111110110111212012222202021202102021221022b
111111111101101100101110111111111011000111101111111101111111101111111111101111010101000111000111110111101111110011111011111110111002220222122202212122212021222b
111111111110111110110101111111111001110001111111111111111111111111111111011101100010111111011011111111111111111111111100011111111122120221102222202202222022122b
111111011110111111011111101111111111001111111111111111011011111101111111111111011011011011111111111100101111111011110101101111110111111122112221222212122121110b
111101101110111011111011110011111111011111100101111101111111111111111111111001111101111100111011111111111111111101111101011111100111110111201111112121121120212b
111110111111111111111110111111111110011111011111010111011111111101111111111111110101111111111101111110111010111011111101110101110111111001022211021100212222022b
110110101111111011111010111111111111111010111111111111011111111110111111011111101011111001111100110001001111110111111111111111111111011110121211212101001222012a
111101001100111001100111110111111111111101110111111100110110111111101111011110111001111111011110111111010110111111111010111111111101111101202010112212001211112a
101111111111111111111111011111011101111111111111111111011110001111111010111101111000110001011111111111101110011101001001111110110001110212212212212201222101221a
111111111000111101111111111111101010101011111011011001011111111101111011111101111111110111011101100101011101101111011111111111101101111101122221012122222112200b
111111011111011111111111110011101111011110111011111111111111111111110111111111111001101110101001111111000111111111111111111011110111111211222100110111120121221b
111111011111111111111111111111011111111101111110101111111110111111101111111101111101011110111101010011111011011111111111111111101111111222210221211212202121101b
110011111011010111011110111111111111111111111111111111111111011111011101110011111111111111101111111111111011101011111010111111001111011211022212211122212210222a
aaaaaaaaaaaaaaaaaaaaaaaaaaaaaaaaaaaaaaaaaaaaaaaaaaaaaaaaaaaaaaaaaaaaaaaaaaaaaaaaaaaaaaaaaaaaaaaaaaaaa1111110111111011100000001111111111112222211121111222122002b
1111111110110110111111111110110111111111111101100101011110111110111111011101111011111011101110111101a1011111111101001110011101110111111111122222210111110221021b
1111011111111100111111111111111101111111110010111111111110110101110011101011111111111100111111101110a1011011111111111110111101011111101101022112122122121211221a
1111111110011111110011111111101111111111011111111111111111011110111111101110110111111110010010011111a0111111111110110111111111111101011111211102201012211120111b
1111111101111111111110111011111111101111111101111111100111011111110110111010111111110111111011111110a1110111111100111111111011111110111011101222110012220112212b
1111111101011111111111111001101110110001101011111111110111111010111110110111111111110111110111100111a1111011111110110111110110100101111110110001111110111111111a
1011111101011111011111111111110111111111111111001010111011011111111011001110111101111111110011101011a1110010000101001011110111111111101110110101101111111011111a