151 22
97 109
3 98
33 75
109 3
64 24
86 50
46 72
102 58
116 110
01011111011110101111110111101a11011111001110101111111101111110110111111111111111011111111a1111122000111022010102202122110021111110011111111111111111111111111111
11111101111111111110111110111a11111111101111101110111101111011111111011011011011010111101a1110122211212222101100222220111220211111111111111110101011111011111011
11011111111111111111111010111a11011001011111011101111111011110111111111101000101010011110a1110202211110121111212102001212012011011111111111110101111101111001011
11111111110011111111001111101a11101101101101111111001111010111101011111011111111011011111a1011202102021112012220022212011201101101101011111111110111001111101111
01101111110111101111111011111a11111011111110101101110111010111110111111111111101111111111a1111220211012202121212221111210122211110101111111111111110111111111110
10111011000111101111111111111a11001111111111111011111110110111001000111111111111111110111a0011121221221121111022220212200202011111011111101110111011110110111111
01111110101000111101110111001a11111110111111111011101110110110111111101111111011101100001a0111201101212100211210121221111021001110111011111111011110111111111011
11011111111110111110111110110a11101101110111011111111101111101111101111111111111101111001a1111221222222122220112211002212221111010111111111111111111001110100111
11111110011111011111110111000a10101110111100111111111111111111111111111111011011001111011a1111020112111222111021112212112102011101110111110010010111111001111111
11010011101110111110111111101a01111011111111101102210122121222221222111121211201001101111a1111121010212021011111121112111012211111111111011111111111101111011111
11111011111011111011111111111a11000111111111111112122222211020221202000121012210111111111a1111221211110112121012210212211101010111101100101111110101011101100111
11001111111101111111111111111a11011010111111101102210122222122222001222002212022111101011a0011222221222221112112122121200212211111010011011111110110001010111111
11111110111101111111111111111a10011110111111011101220121101221022102001100122021111111111a1111202112211111222122212201011212211011111111111011111111101111111011
11101001111111111111111101111a11111101000010110101212011222222202121111111201211111110111a1110121200112212112122111212002210211110111110111101110111110110111100
11111110111111111111111111110a10111101110011111101102121121012121210111101021121111110101a1111211112210220012220022120202111211111111111110111101110011111111111
11111111101011011101111111101a11111111001011011112122210112212211220211111111222111011110a1110112112211012211221212222201111211110101110100111100111111100110111
01111111111101011110100111100a11010101101111011112200211102122112100201221202121111111111a1101220121211111101221210212221121101111011111111110111110111111011011
11000111111111111111111110111a11110111011011111112021122010112222120110120111202111111111a1111221220021201002120122120020111011010110101111111010101111111100111
10101111111110111110110111011a11111100101111011112012110112211201120111022112202111011011a1101012110211022212022021121202122110111111111111110110111111011011101
11111111101011110111010011011a11111111111110111002122111111010121100221211121122111011111a1111110111111111111101111111011111001111111110111111111111111010111011
11111111011111101111001101011aaaaaaaaaaaaaaaaaaaabaaabbababbabaabaaaabbbbaabbabaaaaaaaaaaa1001101011011111111011101111111111111010111110111111110111011111110110
1111010111111011011111111101111011111011001111111020122222201222122002122112211210111110110011011100101111110110010111111111101101110111111111111111111111111111
1111101111111111011111111000001101101111001011110202112222120111121100201221122111110111100110111111101110111111110101011001110100111001111011111011110111111111
1110110000111111111111101111011110001011011111011201201210111220212112211122221111111111101101111010111111011111111101111101100011110111111111111111111111011111
0110111101011111100111111101111110111111111111111112012221201220211120010211212211111011111111101011101111111011111111111111011111011011111111001111111101101111
1111111111110111111111101111110111101101111111110022112221012001112112010002001111110111111110110111111011011111011110101111101011111111111111001110101110111100
1111001111111011111111111110110111111111100111111121120212210111002211221200122010111111111111001111111110011111111101111111111101111111011010011110111111111111
0111110111111111111101110111111111001111101011111002111212121221121122212121222211001101111110011111010101111101111111101101001101111111110010111111111111111011
1111111101111111111101111011011010111111011011111002120102021211101222020122222101000110111011101111111110111110110111111110111111111111111111111111111111101111
0111111111111110111111101111111111111111110011111211002122012020111120110220211111111111111111111111011101111111111111111111111111101111111110111000111111111011
1111111110111100111101011111101011101111111111011112211222121021101102202102112201101111101111111101011011101111110011110111011011100111111011111111111110110111
1111111110101111100111111110110110111111110111111210212022022221212211211221111111111111111110010111001111111111011111111011011111111110101101110011111111101101
1111111111111110111111101011111110110001110100011121212211220122221012220022201011111111111101111111111101000111111111101011101111111110110101111101111001111111
1011111111111111110111011011011111111101111111100012201111221112112221221222010111111111111110110010101111110111101111101011011110011111111101111111010111111101
1110100111101001111111101111111111110011111100111112201002122011022120012112111011010011110101111111111111111110111101111110111111001110111111111101111111111101
1011111111110111011100101011101111111011111111111121120012111222012112121202122212101122101111211122011100110111010111011111110111111111111111110110111110111111
1110101111111111111011101111101001111111111111111002012222211222120202121222222010222012112210211121120111101111101111111110101111111101111111111111111111111111
1111111101011111111111111110111111110110100111111210012222212112010210022221222220222210000121211100221011111111111001001111001111111111111111100101011111111111
1011101111010111101111110111111101111111111111111111200221202220112111112220222110012121222102222112121011110011100101010111111110111101111010011011001101111111
1111111101111011011100110111010111000111111010111122122112221110211111001220112011111212111221210121201001111101010101111010111110111110100110111111111111111011
0111111010111100111111111111110101111101111110110111010101111111111110110222121212002211112222222221001111111101101011110111111110101011011011111011011111111111
0111011011001111111111000110010111111111111101111011101101101111101111011210121111121111211102111201121111111101111110111011011111111111111111111111011111111111
1111101011011010110100011101111111101111111111011111111101101101111011011011221111112222120102122011121110111101101111110111111111011111101011101011111111111110
1101101111110111111101111110011111100110111111111111110101110111111111110211112100212100020020021102022201121202221221101001111111111111110111111111111111111011
0110111111111110111110111111111111111111111111011101011111111111001111112201211120021222122201221121222102120110121120111101111101110101110101011101001111110011
0101000111111111011011111111101010011001111111100111111011111110111110111011201202201122222212121221122202020110202120001111111111101101111101111111111111111111
aaaaaaaaaaaaaaaaaaaaa0110110100010101111110111111111110110111011000111122112202121220101022222012212220222212120222101111111110101111101111111111111111110111110
11111111111110110011a1111111111111110111111011110111111111111111101111111121211022112220021220221210221011121222221212101101111111100111111111110111111111101010
11110111111110101111a1111111011111110111111001111111111110111110101111011121112220212121222000222122221121102102112012100111111111101011111110111010111111010111
01111111111011101110a1011101111110011011111111111011111111111111111011101212220000222222220222221221222020222201120102100111011001111111101111001111111111100111
11011110110111111111a1101111111111101111111111111011110011111111111101002211122102210022221002122022121221022201202122111111110110111111100111111110011101101011
11111111001011011111a0101010111111110111111111011111111011111111111111101122212000112022212201212211222221012221220102111111111110010011111111011111111111111111
11111111000111101110a0111111111111111111111111101111111111111111111111122102221212211011220200222222212211210112120112011111111111100101110111101101111111111101
11111110111110111111a1011110111111111010011111011111011111110101111111122101221122010212210122001222222011112212220001111011111111111011111111101111011011101111
11110111111101111111a1111111111111110011111010011111111111111101111111101221211102112121220211212212101122022101200201011011101111111110111110011110110111011110
11011110001101111011a1111101011111101001000011111011010011111101111111122201021210222011200001110221222012202122221111011111111111111111110001011110111101100111
11111111001110011011a0011111111101111111101101111111111010101101111110120011011020111211202022222212222110221122221210100111110111011001110101111010110110110011
11111111011101111101a1110111111122122122001211221201212021101111111101112210211121110012121122210122221111221221221200011111011101111111011011010001111111111111
10111101111111111110a1000111111222111110221111101212221122121011101111010212212221120220201201222020222102221112111111110111101111111111111111110001111111011111
10101111101101111011a111000101020100001001122211111221111102010111111111111222011112021221201122000122220112bbaabbbaabaaaaaaaaaaaaaaaaaaaaaaaaaaaaaaaaaaaaaaaaaa
11111110111110111120a212011101202222212212220222222212211222111111111102122022202121221201012200112211211012a011010122110111111111111111111111111111111110111011
11111001111111011020a121222221221210022122212110022122121201121111111111121210121002102222102010222222221011a201011020111111011111101011010101111110110111110111
11010110011110011122a212021222122212020221222222120111112010121000110111121000111021211001222102202122200110b122111112111011011111101111111111110110101110111111
11111101111110111111b001101102022222121222121222202100121210101011101111012122202012210120222220021210222012a120121122110111110011111011111111110110011111001111
01110111111111011122b121110211222111222212222122221122211222201011011101122111220111111212122120120112110110a211111121011110111111101011111110101111101101111111
01111110111011011121b101112121101021220221102222211121122212221101010112111121111110210220222102012200101022b220212221101110111111010111001111110110101010111111
11011111101111111122b211120022121222221020122220011120112222221011111011110111101111100121111112101122020122b112111202101110111111111111111101011111111001011101
01011111111111111112a202211111120200221212102221012122211110011111011111011011111111111212120121022221101101b102122020111010111111111011100111111011111111001111
01111111011111111122b122212112100221222222020210101111211221121010101011111110110110011201221201212111101212a221011012110011111111111101110101111111110111011111
01001011110110101122a011211101122212220200122022102021111200011111111111111011001111010220221102122221021122b210122110101111111010111101011110111111110101101111
11011111111011111120b021111022220211012222202222100121221121111110111110011111111101111022001121122221112212a221120112101111111100111011101111011101110011101111
00011111110010111120a112210112202220222222222221211212221201110111111111011111110101111121122211112121120012a211011212111111100110111111011111110111111111111110
01111111010110110122b102201202222000221222220221222122111222121101111011011011110111101112121110112101100212b011122220111111110111111111011110111111101111110110
11111111110111111020b012211111200002221202222122222112221220210111101111111101111111011111012121220101000022b222201221110101111111010111111110111111111111110110
10111100111100011122a200112101120022220022012111220222001011211111100011101111111110011111101001111011011111a101011110101111110111111111111111111110111111111011
01111111111111111112b011210120002222222212220222212112121211121111000110011100111110111111111011111111011011a110111011011111111111111111111111111111111111011111
11111111111101110022a211002121200221201112212022111121111002221101101111111101111010101011111111011110101110a011111111010111111111101011101001111111110101111111
11111110111111111101a111012102102021022000202022212121120121010110001111111110111111111101111110111111111110a111110111101111011111111111111011100111111101100101
00111111111111110101b112022222121220221221022122111102122122111111011111111111011111110101111001110111111011a110001111111110111101111111111110110011111111111111
11101111111101011120b201011121000022222201220122222201110121121111111111101111111010111111111110111111111101a111110111111111001100101011011111111111111110111111
10111111111111111122b201212222122212102222022002111202102001221111111111111111111010111111110101111111001111a111111101011001111101111111111101110111101101101111
01111101101111111111a222120121002212211120020212212011120101111111010110011100101011111111111011101011011101a111111110111011011011011111111101111111111011111111
11101101110111111112a221022211122222212222210122021110202021011111011111111011111001011111111101111010110110a111111010111111111111111101111111111101111111111111
11221211221120222121b200102211221210122021222222220212202112121101111011111111111111111011111011110011111111a110111111110111111111111111111111111101001110111111
12211210111102112002a201210021112102002112222220202111112121201111101111111101011111111101111011111111001110a101001111011011011111010111111101110110111111111101
02121111111011210100a101212112111222102221122021212211111211121111111110011111101001111101001111111111011100a111011010101001111010111111111111110111111011101111
baababbabbababaababbb012212121222212202222120220120112121212221010111011011110111011101111111111101110000111a110111111111111111111001111111100111011111111101100
a00111110022220211101112210111112010202201202122201222121222121101111101111110011111111110111111111110011010a111010111101011011111111110111111011111111110111111
b20211202102121002120021011111101011210211201021210111011110110111101111111100111111101111111110111011111100a011111111101101011111111111110111111111011101110011
a11200112202112111001201111002210210010120201011110111111011111011111111111011110010101111110111111101110101a111110111111111011101111011100101111111101011111111
a10121111101122212211202111212101122201111222111211111111011111000111111111111111111111001011110101001110111a010111111100011110011111100111001101011111101110110
b21222012110221022210111111111101001011011111111111111111011101111001111111101111001111111111110111111011101a110011111111110010110110101111111111111011111100101
b22122121110100121211110111011111011110110111011011111111111101110011111100101110011111110101111011110010111a111110011010111111100111111111011111101110111101111
a22210201121221122011111011110110011111111110111101111111111111111100111110011100111101011111010101011111111a101001101111111111001011111110101111111111111000011
a21021022121222111201111001100110111111001011111111101111011111111111001011111111111111111101111111110111001a111101101011110011111111111101111110101111011111111
a21110221020111110201111111111001111111000111111111111110101101110110011110011111100011011111111111012001120a111202112211122211020101111111010101111111100110111
a12222021221001211011110110110111111111100111111110110111010101111111011101111110110111111111111111112212210a212221201112211121222021111111111111111111111011111
b22122211120111211201010001101110111000111111011101111111111111111111111001101011111111111111110111111000220b122201010212211222202121111100111110110111111111111
a10221012011022121110100011101111101010111011111011111101111011101111111111101011011101111101111101110201211a101101221110112222211211111110111101101110111001111
b020012121212212bbbaaaaaaaaaaaaaaaaaaaaaaaaaaaaaaaaaaaaaaaaaaaaaaaaaaaaaaaaaa1111111110111111111100111201220b102122221212211000021201111111111111110101111111111
b212101020111200b21111011111111110011110111110110111011110011111111111011111a1111001111100111011011112221120b211201021211101021111100111111110011110111111010111
b022020011222122b11001101011111111111110011111011111010111011111101111111111a1111111111111111111101101122122b022222221111102202212121000111111111111101111010110
b002101111210122b12101101111111100110110111011110111001111011111100111111110a1110111111111000111111112012221b212201200112012222122211011101111001111110111111011
a112111022202210a22111111111110111011111111101101111011111011111101011011111a1101101011101100111111011112221a122102120220222112201011111111111011111111111110111
a221221122122122b21100101010101111111111111111111101111111111111111111111101a1111001111111011111110101212111a122110221012121211200211111111111011111011111111111
a120212211011221b21010100011111111111100101100010111111011111011101111111110a1110101111011101111110110111012b010111202212212112011211111110101111101101111111110
a112011111112212a11111111111010111011111111111101101111001111111111110111101a1111001111111110111101102201220b100221020212212012120011111011101111111111111111111
b212011110002122a11011110111010100110011101111111111111111011111111111111110a1111111111101101111111112202021a121112201202112100112021101111111111110110111101111
b222222110121112b21111001111101111111010110000101011110111111111111111111011a1011111111111111111101112211122b112122020012112011111110111101111111111011100111010
a120110221222120a21101111111010111110111111111011101110111111111111111111101a0110110111111111111111111021211a212112212011222220102211011111100101111111000111110
a212211010011120a12011111110010111110111111010100110111010011111011111111011a1111111011111111111110111101210a122222122022121211222121001111110101111111011111011
b212210202222221a11101110110111111101101110011111110111101111101010111111111a1010111101111111111111112202121b202102012102211210110201011111011111111111101011111
a012212211120201a22111001111111101111011111111111111111111111101111111101111a1101101101111101111111112212112b011122211112011120121101101011111100110011111001111
a121000012220220b02101111011110111100111011111010111101110110110111110111111a1010110111110111011111101012022b220222222020211112122111100001111111111111111111010
a111011111111111a11000111110110101011111101111011111111111111111100110111111a1110100011101111011111111112112a112110111120112102122221011111111101111011101111110
a101111110101111a11111111111101011101111111011011101010111111011011001111111a0111111111010101011111112202112b120102112112020111110111011111110111111001011111111
a111110111111011a11110111010111111111011111001100111111111010011011101100111a1111101011100110111111112221121a112101101020202221111011101011111110111111111111111
a110001111111111a11110111111111011111001111111011111100111001111101101111010a1111111011111111111111111102020b012111211221111101221220111111111111111111111111111
a011101111111111a11110111010111111010111111111011001111111101110111110111111a1011101110111001001111111200121b222221122112021211121121011111111011110111011001001
a001100111111110aaaaaaaaaaaaaaaaaaaaaaaaaaaaaaaaaaaaaaaaa1101011011111111111a0110110111111111110111111122101b111121222121210121210010111101011111011111101111110