123 5
0 21
51 18
107 68
116 94
84 0
20 74
85 42
141 18
119 77
11110110111111011111111111101111011101111101110111101111111111101111011201110101120211211011121122011111110101110001a1111111011011111111011111101111111111001111
01101111111011111110101100111111111111111111111110111111111111111101022220221102211112012122121011020111111111101110a0111110011101111111011111010001101111111111
11011011111010111110111011111111101011011110001111111110011011101100120011202222211112211201221112111111111001110111a1110111011111111000011111111111111011001111
11111001111111010111111111111111001110111122120010021222120200222101111121222222100022210121022211200011111101111010a1111001112112200221222122000211200121010101
11111101111001111110011111111110111112111020101100101110100010212110012210222212210021111000011122101011111111110111a1101111110212210121210221221122202111121111
11100110110110111111110011111111111021122110022201122222222222112021122010122012102111210112102221211111111110011111a1101111102122111222121122112102012211111111
10111111111110111111011111111111111110011111001211221112102020212210102112122112221220111121110102121011111111111110a1111111110100111021222212111211211111200111
11101111011110111101110111111111001100212211220022211102212112012201120222122211112222212221100001121001001011111111a0111100110112121121222011221211010202112001
11111011111011011111101111001111100000220222021101122110210100202021122021222202222122101022112212221110111111110011a1101111101222110212121222121002220100212110
11110101110011001111011101011111111001221020022202202111110220021221120122221210222121221222200122211011001111111111a1001110110122212112220001101212110101210111
01111111111101011110111011110110001021011111221012110210110211012101122001200100121102121112121221121111011100111111a0111111111001112112211221112221112122211010
11111111111111111111111111111111101021111012211102211012220211122011110101110102001111221212121222121111111011011011a1110111112221222121001211102001012121121111
01111101101111111111101111101101001121112222002200101220111200112100102221121101222110001221110221111111101111011101a1110011111212120100101112212102112111210010
10111111101101110111111010110101101012112110001100121112222102221101122221221211211122222112220112121011111011111011a1111111102021102222121021220200121111112111
11111111101010101101111111111111111011201000021221022220121121122201111101111111222112212222211221121110111110111110a1111001101120222120221202120120202202212101
11100110111010110111011010101110111121010011022110221022001121222220001112211212002111221001010010011011101101101110a1101111111002120112112111212211012101221111
11011011110111110111111111111111011121022222212101221101121222122121011110111111101100101101111100101010111111111111a1111111111022122121002220211122110010212111
11111111111111110011111111110111111012001221212021020110212221200211111111111111111110111111111011110111111111100110a1111111112001212002222111111101012121211110
11111111101111110111111001101110111111111110120112112102201122122111001111111110110111111110111111111111011111011011a1011101112222211121102220112002111021201111
11100101011101111111111011111111110121020211010111121221202110021101101111111111111110111110111101111111111111111111a011110101111020212211aabababababbaaaabaaaaa
11101101111101011001111111111101101101011012101221102122222120211201111101111011111111101001011010101111101110011110a001111011212220111202b112202222222212112110
10111111110111111011110111111111111112111222220111112021111022221221101111111111101111111101111011011111110010010101a111011111121121112121b111212022220101201111
01110110111011011110011110111111111122210121221210000122010222210020111011010101110011111011011111101011011111111111a111111011200110112102b221111211020200211111
11111110111101111010110011111101111121101201202221210022112012121101111101111001111110111111111110011101111011011110a110111111102211111122b121221022210121011101
01111100111111011111111110111111011111001121122011221022212122220011110111011100111111111101111011010110110111110111a111111111211220121021a101112000121221211011
11101110111111111101111111001111110120121212211010112110221220020121111111010011111111111110101111111111111111101111a011101111200212112220bbbabaabbbbaabaaaaaaaa
11011111011111111111111011111110011121202022121211211212022202021001111100111101101111111111111111111101011111111111a011010111111012102112ba1212101112221211011a
11110111111011111011101000011010111102221012101121111121112012211221101222022212112021222122122211200111111111011000a011111011120101122212aa2120201201102112111a
10111101011111111110111111111111111101201121202012012211122221110120110201222222221102112112211001100010011011111111a011110010112012212202aa2211202002211101101a
10111111111110011011111101111101111011200221111101110210202211202011111120102122211102110122112121122111111110110111a111111111111222211010ba2221221221212211211a
11111011111111111111110111110111111121112201210212111221121110202120111222100011220121211020022021122111010111100111a111111111022110210210aa1222002010121210200a
11110011110111110111111111010111111121011221021122102211211211212001011200120122122022201120200112122111000110111101a111111111212021121111bb2101211112112210001a
11111111111111111011111111110110111112102202222122102211122101202021110021201001021101212110200022122111111110111111a110111011121222101121ba1121211200012201211a
11111111110111101111111111011111101001120222211121102102221022021210102102222120211211212212212112121101101001111010a111111111020002111221ba1011102200101221211a
aaaaaaaaaaaaaaaaaaaaa11111011111011101101111111110100111010111111110112112002111021221122012012101102111111111111111a111111011011100100110aa1011111111111100101a
11001111111110101110a11101100111101111111101111111110111101111111111011112212210001110211222211002121001111011111101a111111011111111011100aa1110101111111001111a
10111111111101111110a11111111010110111111111111111011111111110111100012212121122211122202211021110210111111111011001a111101000101110111111aa1101111111111101111a
11111111111010111011a01110111110011011010111100101001110111111111110112221111122111122020121222001220110101111111111a111101101101011010111aa0110101011111011111a
11111111011011101011a11101001010111101101110111111110011111111111101012210012122220010020121200121101111111110111111a111111111110011111111aa1111110111110111110a
01010111111101111110a01011110111111111111011110111111101011111111111102122021112022012221212221211011111111101111111a011101111011111111111aa1011101110111101001a
01111111101110101111a11101111110111111111011110011111111011110110110111222012120112110002202210111221110011011011110a100111011111111111111aa1111111110111110111a
11111111011111011011a11110011111110111111011111111111011111111111111112120221102112210122220212021222111100100101111a111100000010011011111aa1110100001111010011a
01101111111101111011a10101110111111111111111111111110101111101111111012211120012022212010211212110002111111001001011a111111111111101101011aa1111101111011011011a
11010111111101101111a11111110111111011101110111111010001110011111111010212221020212111110211202102122101111100111011a101011111110101100111aa1110111111110111111a
11011110111111101011a11111111111111111111110111111111111111111111101110110110011221210221112222111121111111111111111a111000111110011110011aa1111111110111111111a
11011101011110111111a10111111110010111111111111111111101111111111011111222101212112112222122221200022111011101111111a111111101011111111111aa0111100111111111111a
11111111011101110111a11101111111011011110111111111111110111111110111001121211211122022022201122111210111011111111111a111101111000011111111aa1011111011111111111a
01100101111111010111a11111111111110111101111111111111111101011101110112122212111022221121201221110102101011100111111a011110100011111011110aa1101110101111101111a
11111111011111111111a10111111100100011011101100111111111111011111111102222101110212212011012112210011111101110111101a111011111011111010111aa0101111011111011111a
10111111111101111111a01111011111011111111111111110111111111111111111111010020120111121211121112010210111101111100111a111111111011111011101aa1101111011111111110a
11111110111111011111a10111101111001101111111111111011111111111001011111122102201010210220222221211212011000111101111a111101111111111111110aa1011111111111111111a
11111111111101101111a11110111111001110111111101100110011011010111001002011112110122221222210201211111110011000111111a101111111111101111011aa1101111101111111101a
01111111111110011100a01111110011111111111101011111101111110111111111111202110211001002221021121021220111111111111101a111100111110111110111aa1111111111010111010a
10111101011011111101a11101111001010111111111101100011101111111111111112002012222221211220222000121212210112111211122a120211111111111111010aa1111111111101110100a
01111111101111110111a11111011111111111110111011011011011111111011111111200212122001120110122222212201102211122101212b221211111111111111111aa1111111111111111011a
11111101111111111011a11111010111111111011011111111110111111111111111112201102221211121222121202010202101011121211021a120022011001100111111aa1111101111111111111a
10111111101011111111a11111111111111011111101111011111111111111111110111121111210111210021022202202022111102210121212b100121111011111111110aa0101111111111101111a
11110111101110111110a10111110111111101101100001110111111111111111110111202121120122100211212022120222110202022112200a011011111111101101111aa1011111111111110111a
10101111111111111111a11011111111111110111001101101101111111011111011111001101111111110110111121000111212201111222202b222221111101011111101aa0111111111111000111a
11111012022221021011a21212102112211110111111111111011001101111111000011011111111111111111111210111120122211211111011a201212101111010010011aa0101101110111111111a
01110102112202120121b21111022111111111111110011111111111111111100110110111111110011111111111010111022011010221020220b022101111111011101101aa1111110111111110111a
01110112122022200021b01122011010212210010111100101010110111111001111011111110111111111111011211211221201210212111221b212210101110011011110aa1111111110110011111a
11110220021100112121a21110021212122110110101100101111101111111110111100011111111100111111111110222110022220022002221b210102120210010121111aa1111101111110110101a
11111200212021111012b21121111211211111101111101111001110001011011111111011001111111101101101122020202022122022222222a210212120112212222111aa1110011111111110011a
11111001121111102211b10122220111121200101101010011111111111111100110111011111111001011001111121211222200222222221102b222221211221021020010aa1111010111111011011a
10111211122221111212a21111020122210011101111111111111111011011111100001011101111010111110111200201110002022012022101a002222002220010201111aa0111111111111111010a
11110211212112210220b21122001122001200011111111111011111100100111011101101010111111111111101221001022121202202221102b000022111222001122111aa1101001111111111011a
01110001010101210111b10112112111120210111110111101111011111111110011111111111001111111101011222221220100002101222111b222220220222202212111aa0111111111111111010a
10110121121110212022a11110012122122011101010111110111010111011110110111010100111111111111111221222011101021211022221b222222211101111220110aa1011111111111111101a
11001121120211202212a01222122120112011111111111111111101110011111011111011111111111110110111011122021201202122222202b101102022101220121111aa1011110111111111111a
10111211212212110112a21022221101222111111111111111011111111111011111101111101111111101111111121100011212200112212101b212022111020222101111aa1111101111111111111a
00111110201111121221b22212221021121211101111111110110011111111111111111111111111101111111101212120220021212202212222b212112102020112021111aa1111011101110111011a
01110201121002012220b10212212121110211011111110101111101111011110110111111111111111011111111210121222211120021121222b202211221011210220111aa1111111110110001111a
11110122202221122002a21001012112120211000111101111111010111111110011110111111101111011110111201122001200220122112101a220222012210222021011aa0100111111111111111a
11111201111222020012b22222220202220111111111111111110111111111110111111001101110011111111101200111200101222222100102b002222112100002001011aa0001011110111110111a
01111212201022120112a22121121221121011001010111111111101111111111111101111101111111101101111012222212111121222011001a222222021202121212111aa0010011011111111101a
11111222010112211121a12201112112220111111011100011111111110110110101111111001111000011011011121112101112120120021200a121222110222211201001aa1111101111001001110a
11111122111202212220a22121222201122211111110101110101101111100111111110111111011111111110110022221002112120022222211a210102211101122201101aa0111111101111011111a
11101202002211121011a22220200221112211011111111111111111010110111111111011111111111111111110122202122112121022222202b220222221022112222100aa1111110011011111111a
11111201122010011200b12112111221112210111111111111000110111111011111101111111111111111111111021122201212222222221022b222000222002021211111aa1110101111111111011a
11111212102012010112b22010221011100111111110111110111111111111001111111111111101110111110111010012221212221110122222b201220122120210200111aa1011111101100101111a
10111212221011110122b12101120121002211011110011111111111111111101011111111111011111110111111112021122012222222222121b220202112222222220110aa1111111111110110100a
11111021021111211112b20221000001222201111110110101111111111110100011011010111011111111111101200010122221121222111020b212220102122222201110aa1111111111111001110a
11111021122121012021a02102221111021111111111101111101111011111011010101111111111110111110110001222022100222220221220a022022121121200122101aa0111110111111110111a
11111201112021212111b11122121221022100111110110111111111101111111111011101111111111110011111110110111010022220221202b002220122022221200111aa1101111111111111011a
11011000010012212212a21120111102122011111101111111110010111111111011111110101111101111101010111111011121112112022222b222212202102022000111aa1111011101110100001a
11101212021010222211a12111221110122111001001011111111111101111111011110111101111111001111110111111110112122021220222b202021120112021102111aa1101111111111101111a
11111122212222200101a22122222201112110111111111111111011111111111111011111100101111010111111011011111211221111010210b222212210212211112011aa1100101011111010111a
11110111212220222010b22111122022112111011111010111101110111111111110111011111111111101111111111011010221220221111102b212201122212022220111aa1111011011111111111a
01111022211200121011a22102222211020211111101111111111111011011101110111111110111101110110101011101110110222122202210b202100222122120122101aa1111111001111111111a
01111111111110111111a10011111011111111111111111111111101100101111111110111101111111111100111101111101211022022020110b022220210022220201101aa1101111111111111111a
11111101101100111111a11111111111111010011111011001110111101011111111011111111111111111110111111111111011220122211012b221202220010220111101aa0111011111111110111a
11101111111011001101a10111111111110111111111110111111111111010101111101111011111111111111111111111101011211211222220b112122211220022221011aa1111111110101111101a
10101010101111111111a11111101010111111111111110111111111111111111011001100111111111111111011111111111212011222220122a221211221222011110100aa1101011111111111111a
11001111101101111111a11111101110110111111111011011111111011101110101111101010110101111111101111101101112212111011121b222102111022022101111aa1111111111100111111a
01101111111011110110a11111111111101111111110111011111110001011111111111011110111001110010111111111111112102211120201a020202120021111101111aa1111101111110111111a
11111011111101101111a10111111011111011111001111111111010011110010111111111011110010111110101111111111022121022112222b222110121201121101111aa1011101011011011100a
01011011111100101111a11111101001011111111111011011100011111111011101011011111011101111111111111111111121102201022121b101112221022121111111aa1111110111111101110a
11111011111111011111a00101110111111111101011100111101111000111111111110111011111101111111111111111111121222211021022a201122220212112111111aa1111110111011010010a
11111111101111111111a11011011111110011111111100111100100101111110111001111111111101000111111011101111011122102211020b210211202211012111101aa1111110101111001111a
01101101101111111110a10111111111111111110101110111101111011001110111111011111111111110111111111111111010222211112111a111222122122211111111aa1110111101111111010a
11111100111001111110a10111111111011011111110111111011111110010111110111111111111101111111111011111110012121220212122b212200101221012101110aa1001011111001111111a
11110011011101100011a11011111111111111111011100111111011110111111111111110111011111111111111111111000222221122120111a101222212111112111111aa1111011011110111110a
11111101111111110111a11111111001111110111110010111111110110111110111111001111110111111111111110011111112111010122220b112011202221202111110aa1011111110110100111a
00110110011111011111a11111111111011111111101111110101110101110111111100011100111101111111010011111111222022111201202a112120102012211001111aa0111110111001011111a
01111101111101111110a10111111111111010111111011111011111111111111111011101101111111111111101100111001121212022211210a111101101121202111101aa1110111001111101111a
11101111111111111110a00011111101100111011111111110111111101110011111000111110101111110111111110011111102202221211020b212102222122120110011aa11011111111111011111
11111111111111111111a10111011111101101111111111111001011111110111111101101111101111111111101111101111222121022121111b120122010212010001111aa11111111011111110011
11011001011010011011a11101111111111011111111111111011111111001010111001111110111110011101111110111111212020221201220a221202211222221111111aa11110111111001110110
01111111111111111101a11101101111011011110111111111111101111011111111011100111011101111111111101110111212012122211210a222122201110002011010aa11111111111111010111
11111111101111111011a11111111101001111111110111111111111011110111111000111110101101111101111111111101110110011101111a110111011111111111101aa11111010111111101000
11111101111110111111a11100110111011011011111111111111111111110011111111111011111111011110111101111110111111111111111a101111111101111111111aa11110111111111110110
11111101011111101110a11110111011110111111001101111111011111110101111010111001111011110111111101101111111111011110111a101101111111110111111aa11111110111111111111
11000011111111110111a11111111101111101010111101100111000111011111101111111111111111110111111111101111111110110110011a010111111111111001111aa11111100111011111101
aaaaaaaaaaaaaaaaaaaaa11111101011111110111111111001101111111111011000111101011101111110111111111111111100110111010011a110111011111111111111aa11111011111111011110
10110101110110101111111111111111111111111111111111100111011010111111101111111111110101011111101111111111011011111111a101100101111111111111aa11110110110011011101
11101111111010111111111111001001111111010111011111110101101111111111011111101111011101101111111110111111111011111110a111111110111111110111aa11111110111111101010
11111111111101111101101010010110111101111101111110011010111111111110110111111111101111011111110000111111101001111011a110111001111111011011aa11110110111111111010
00111110111111110101110111011011111111111011101111110111111111011111111111001011010111011111001111111111100111101111a111111100011101111011aa11101011111111111111
11111111111111101011110011011111011111100111110111001111010111100111111111110111111110111110111111111001111110110111a101111101111111000011aa11111011111111001110