28 18
152 119
55 74
89 70
77 96
144 1
97 9
151 26
75 59
154 89
011111100101011101111111111111111a1111111101111111011110110110111111111111111101111101122220b0112222102201112112211111001111111101102011000110200102220012220022
111111111111111110100111011100011a0111101110111101111111101111111111011111100111112101000220a0102021010112221111211110111011101111212022020221212002020121010102
111111101111101111111111111111101a0101101110111111111111111011011111111110001001110221122001b2211212121001112022011111111111111111022120111110201111220021121002
110101111100100110111001111111110a1111110100111101111011011111111110111110111111112112212121a1220211212222112221111111101001110011220022110001110211020211211211
101101011011110001011111111110001a1101111101111011100111111111111011111111111110111020122202b0222212110210221102211111111100111012111221012002022110221101111211
111101110110111111111111111111111a1101110111111101111100111011011111111111110101112111120020b0102110220100022122011111110111101101101111021211222100121121212121
110111111111011101111010011101111a1010101011111110111010011001110011011111110110112110212121a0211211100021222012101111111101111110010122121112221212221222112220
111111011111111111111111111111111a1110100111111111111111110111101101111001111111102111110122b1021212222022101222111011110111111011211212112111120211111211102121
111111101111110101101110101111111a1110101101101111011001111111110110111111101101100211200001b2212222010212211112111010111110111111111122111112221111200112000220
111111111111011111101111111111101a1111110111101111111111001110111111111111110011112110222120b2021221221212222111111111101111110111221211021221121210121120122011
111111110111111001111111111011111a1111111111110101011111111110111111111110101011012122101220b1100112210221211112211110110111111111110110221110122112202112122220
111111111010011111110111111111110a1101111110111111111011110111111011100111111111110211002111a1011021120101101222211111110111111112222222212222022212220222222220
111000111111101001111011010011111a1111110111111100111110111110101101111110010011101011122212b2112012210202100002110111111111111011012120010022212222200002202222
111111011111110111110111011111011a0111111111111111101111111111100111111111111101112202111022b1202122120102101100111111111110110111200102202202221210221212122222
111111111101111000111111101110011a0111111110111100010110011111011111111101110111112121112211a1211111001020121101111011111011111111120100222020222222221120010220
111011111110011111101110111101011a0111111111101101011011111111111101101001110101112121222022a0122101220121202012011110111101001101010011100211222222121022221011
111110111111101101111110101111101a1110011111101101110111110111111111110111111101012202120221b2112111111111021202211010110110111110001110122222220002222022200221
110111111101001111110111000111011a1111011010111111111111101101111111111111011111112111112112b1210221111221220202111111011111111001111011111121022011122102100122
011010111111111111111111111111111a1111111101111111110111111101111111101111111010110021111011b1101200121021220110111100001011111110111001212100111122012220120020
110111111110111101100111101111111a1010111111010111011111011110111011111111111111112122102222b1120200012201111221211101111110010111111010111122111011002022221222
111001111111111001111111111111110a0110110010110110111111100111111011111111111101102220211122a1102012222112120112201110100110010110111011221001102112111122110201
110110111110001110111111111110111a1111011011111011111111111100001011111111111111010021222121a2211222212121202221211111111101011011000101011220102221101101111221
010111111011101111111111111110111a1111111111101011111111111111111111111101111111011010021212b1100111011120022001111111110111110111111101211120222112221012221201
111111110110111111111111101110111a1111111110101101111100010011111111111101111110010100221021a2101012102221222111011111111010111111111111101220122111011212021121
111011111101111111111011011110011a1111111111111111111010111110101111111111111111112122221111b2002111211222000122211111111110111111111111220201222122221111212211
111111111001111111100111011111101a1111101011101101111111101111101101111101111110111011111011a0101110011011111111111001111010101111011111011121211022012020112021
010111111101100111111111111101110a1101111111011111111110101101110111011110101101111111111111a1111110011101011010101011111101011101111111120201020212001021000202
111110111110101111111000111111111a1111110111111110101111111111111111011111111111111111010111a0111110111111111011101111111111110110111111102112122112202021111011
111010101111111111111111111010011a1000111001101111111101011011011111101100111111011111111101a1111110110111111111100110111111111111111010112210110121212222212222
111010011110111111111111111010111a1101011111111111111111010111111011010111110011111010111110a0101111111110011001111111111111111111111101122112102101210012111012
101111111011111111110110100111010a1111111111010111101111111111110111110000110111110110110110a0111111110111111110110111110111011111110111122210120201010122121011
111101111111001011111101110111111a0110111110011011111111111111111111010010111111011110111101a1111110111111111111111111011110111011111111221102221221211102122212
001011001111111011111011101111111a0001010111110110110111111011111111111010101101101111100111a1111111111101111111101011111111111111111111211021202121121221012011
111010111011101111111111111111011a0110001110111011111111101110011100100111111110101110100111a1111111111111010111101111100011111110111111200112201020120122112101
011111010111111111111011111111111a0111111111100111111011011111111111111001011101101111111111a1111010101000111111101111100111111001101110201122120222122021122102
111111101111111111110011011111101a1111010111111111111111111111110110101110011111111110110111a1011111111110111111011100110010110001111111122011121011202222101012
011110111111111111101111111111111a1111111111000111111111100111111111111001111101111111100010a0111111111111011001100111110111011110101111100112021010222111121100
111111011111011111111111101101000a1011111111111111111111111111101101011110111110111111111111a1101111110110011111111111111110011101100111212221122221112111020020
111111000111101101101111111111111a1111111111011000111110111111110011111111110111111111111110a0111111110111111111111110111111111110111110222112121002021122122111
110011111111001111111111110111001a0111101111001100111111111110110101101111111111111110101111a111110110110111aaaaaaaaaaaaaaaaaaaaa1111010111111211022221121211111
011111110111111110010111001111001a10101111111111110111111111111111111111aaaaaaaaaaaaaaaaaaaaa101111011111001a1111111111101011011a1111011221212102112110120211012
111111011111101111111111111011110a11111111110111111011111111111001100110a11111101110101101101101110111100111a1111111011111111111a1111011112212122022100111020221
111101010111000010101101111011111a11111011111011111100110101010111110111a01110011110111101011111011100110100a1011111101010101101a1111101111110111111111101111111
111111101111111011111111111111111a11101101111111111100110000111111111101a11110111111110101111111111110111110a1101111011111110101a1111101111011110111100111111110
110111011111011001111111111111111a10101111111111110111110111121120121222a21112221220121202111110011101011111a1111110111011101011a0101101101011111111011001111101
110001111101111111111110011111111a11011111111111011011011001222222210211b20120022102202011211111111111101110a1111001111111111101a0111101101011111111101111110110
001101111111011110111111111111101a01111111101010111111111110210012122112b10222122221021012011111111111111111a0111111111111101011a1111111111101111111101111111111
111101111111111110111011111111111a11011111111101111110110111220111221002a20212212012211121111111110001111101a0111111100111010101a1111110111001111111111011011111
111100101011111001010111001111110a11111111110011111111110111010210210211a21102120011222222210110111111101011a1111110011011110110a1110110110111101111111111111111
111111111111011111111111111111111a11101111101111110110111111200110122211a10122102021112222111100011111011101a1111111110111111111a1111111011111111101101111101111
111110111111111111110111011101100a11111011011110111111101110111010211112b10211110010211221200010111100111011a1101110111110011111a1101111111101110111111111101111
111110101010011011101010011100111a01001101101111010101011011112122212212b22112011102212102200111111111010111a1111011110001110100a1111011011111111111111111111011
101111111111111111100011110011110a11111111111100111111101111102102212222a10212002110220022211011111101111100a1110111111111111111a0111111101111100011110111110100
111111111011111011011111110111111a10011101101110001011011111121211021112a12121110221112212111111111111111011a1111111111110011110a1110111111100111111111111001110
111111110011011111111010111011001a11100001110111111110110011121200212002b22121112212021111211101101111111111a1111101111111101011a1111011011111111111111111111111
111010011111111111101111111001111a00111101111111111100111111022112012011a12222201202220222222011112121221011a0101111111110111101a1010111111111001001111110001111
111111101111101111011001101111101a01010011101111111111111111111212001111a22110021122202022101212101110221010a0111101011111111111a1111101111111101111101011011111
110111111011111011111110110111111a11111111111111111011011011222212021111b12212001211120121110212011211222110a1110111101111011101a1111110010011011011110111100110
111111111001111111110000101110111a11111101111111111111011111100122211112b22222100112022020102121211210112111a1010111111000011011a1111011011111111110111101111111
111110111011100111101111111111111a11111120210002211122020211022212022102a11202221222212122112001122112221111a1111111001111111001a1111111110000101110110111111111
111111111110111011111111111111111a11111111121122111121121002221212222222bbbaabbbbabbbbbbbbbaa101122110021001a1111110011111101110a1111111111111111111111110111111
110011100101011111101101110111111a1101111022211202110112122202220122222112122200112212022121a021011211022001a1101111111101101010a1111110011111101011111010110101
111111111110110110101111110001110a1011111111022111101121110221112210222120202222222022202122b210122211212111a1111011101110111111a1001100110111111001111011011111
101101101111111011110110111111101a0110112110100121212122002122221110002122211022202100222221b221021211202111a1101011111111110111a1111111011111101011111111101111
111111111111111011111011011010111a1111111110211120000222210211222120022222101200020112212202a222222112200111a1101010111111111011a1111111110001011111111111010110
011111001011111111110011111111111a1111011011202011120102122102021211221110122010222202120101a222112222121111a1111111111011111111a1111111101111111111111001111111
101111111111111111010011111100011a0111110102221112212221122110112101200122210202222121121222b101012121102111a0111011111111111001a1111111111110101111001101111111
111111011011111111011110111011111a1111112210011200122122221022110212222210122020120212220222b101011212000011a1011110001011011111a1111111111111101111111101010111
001111111101111111111001111111101a1011111211111010121122021002210112202120120121222220221221a212111110222111a1111111111110011101a1111111111100110110010110111111
111101101011111010111110110111111a1101112212212011222112101112221120020102122121112222001221a100212110222100a1011111101111111111a1001111111111111011111011111111
101111101111011011111101110111111a1111100111121121111122121102222222212211022221222021220010a111120210011010a1111101111111111111a1111111010110011101110111101111
111111111110011001111111111111111a1011112002221120112100022121022202021202212212222102120221b220011112110101a1001111010111111111a1010110111011111011110111101111
101111101111111111001001011110111a1111102221212121012221002202022100121222121122202222212221b221011101110111a1011111111110111111a1110101011101111111111111111110
110111111111011111111011111111000a1011110222111111110102102111222122122112121220222222202022a110211212221100a1111111011111111111a1011011111111100101111011000111
110001111011111111111101011010011a1111111122212101011121121121012122022210020211222212121221a121222211111111a1111111101111101111a1111111111202020111220121122221
111101101111101111111111111111111a1011110211122212222021112111101102111110120211201101121102b211210112110111a1111111011011111011a0101111001101222102122221100212
111111101011110110111111101111111a1111112112121202012122212202220112222111210220001210122002b102210110211111a1101100101111111101a1110111111112001222222112220222
111111011111111000111101111111101a0000011201112110211222110211112222210111122212201221112122a110121210122111a0001000111011101101a0110011101001211100220121212102
111111111011111101110110011101010a1111111110121122212111110102110001111110122222111212211111b122121021102101a1111010011110101110a1111011110111211012120122211100
100111111111000111011110101111101a1111100221112202122221211020112222112111011202122202000212b021110121222001a1111101111011111111aaaaaaaaaaaaabaabaaaababbbaaaaba
aaaaaaaaaaaaaaaaaaaaaaaaaaaaaaaaaa101111120121121211aabbbbbbbaaaabaabaaaa1112002222021120211a212222120112010a111110011110101111110110111011120221001202022111121
1111110111101000110111111101110011010010111012111011b2210202111020221220a1212021002212212212b210221222110110a111111111011111111111101111101221002122222222221022
0111101101111110111111011011111010111101211111210220b2122111122212212210b1112200222212222202b012021122222110a101111111010111011111111111101122110102020120112111
1111011111111100111111111111101110110111110212111101a1200222202221222201b1221221201222222012b212110010122100a010111111011110101011001111101102102202122121220221
1010101101101111111001111111011101111110210011110211b1100121002212021100a1220112220122210201a122111111222111a001101111110110111111111011100211210121121211201222
1011111101111001110011111011011111001111120112122202a2020011221211212022b2122220222222220221a121210202102111a100111111110111111001001111111212121112120112121210
aaaaaaaaaaaaaaaaaaaaaaaaaaaaaaaaaaaaaaaab22111221211a2111020010221222001b2122002222221021101b111111111011111a111011110110110111111110111101221102212021022212110
0111111111110010011111110011101111111110b02221111210b1222202202221202200a1100202200210111001a111111000101111a111111111110101011101111011110122210212022011121000
1001110100110110111111101101111111111101a21012222011b2222222012222022122b1211120222112222212b011111111011111a111010111111101111111111111011102111211212011012022
1111110111100101111011111011100111110100a21212220121a1110110112022222222a2111112111111102112a100111001111111a011111110101111010111111101011121222111201121112122
1110111000011011111101111110111011111111a11111111110a1111111101222122021a2211121211020112111b110110111110100a111110001101110101110011111001121110112101111221101
1101011001111111110111101110111011111111a11111001111a1000110111212021102b2211101102102112222a100110101111111a100111011111111111111110110110122100122111101222111
0011111111101100111111111111011011111110a11101111111a0111111112222201200a1212012020112002221a111100101011100a011111111111101111110111111011122121202211120222112
1111111111111011111111111111111101011011a01111111101a1111111002222212221a0022022101212121212a111111111111111a110111111110110111111111110110020012110121212111121
1011111111111110111011101111111111111100a11110111111a1110100111221010211a2121021200212001110b110011111011110a111111011101110110100110111110121112112111012102222
0110111011110111111101111101110111111111a01111101111a1110100112212001122b0102022211220011222b111110111101111a100001101101110111111101011111222121222001011120120
1111011111011101111011111101001111111110a10111111111a1111011112121211201b0220210021112021121a011111111111111a110111111111110111100111101110122200222211221002222
1111110111011111111111111111110111111111a01111101111a1011101011221101001b1121110221122012222a111111010111111a111111111111111011101111111111222122012101122121201
1111110101111011101110101101111111111011a01011111111a1111111112201110021a1201120211201102121b111111110111011a111111111101010111111100101101201222122212201201221
1111111111111111111111100011111011111101a11101101110a1110111112102100110b2112121220110211011a101111101111101a011111111101101111110110001111112121212211200110011
1001111111110111101111111011111111111000a11111111111a1111111110122111200aabaabbbababababbbaab111101011101011a111010111111111111010111101111211021121202111111122
1101011101111111111011111101101101110111a11111111011a1111011011012221222222022122222212202222101111111011011a111111111111110110101110110111122122022200012202111
1011011101111111011111011111111111111111a11011111010a1111101011222122220021201222121212212121111011111111100a111111111011111111110111111010221102022122201210000
1111111011001111111111111111110001110110a01110111111a0111011110212212210220112201202021112221111101110111111a111011111111111111111100110011210112221211122200000
0011111111111111001110011111111110111111a11011110111a0111101011211112202212222121000221121222101111101111101a101111111111111111111011101101212221122111102120211
0110111111011111111111111110111011010111a11111011111a1111110110201202120222112001111112120222011111111101111a110001101110111101111110111110010111011111111110110
aaaaaaaaaaaaaaaaaaaaaaaaaaaaaaaaaaaaaaaaa11101111101a0111101111111211021011221002212122221110110110111111111a111111111001100101111111110011110110100101111110111
1101111110111111111110000111111111111111011110111101a1111111111212202111221021100120210201112111011000001110a111111111011101111110111111110100111110111111110111
1111111111111110111110111111011111111010111111111101a1001010110212101211200002001111001220221111111111111111a110011101011011111111011111111111110111111111111001
1110111111101111111111111111111111101111111011111111a1101010101121220022010221212112211010012011110111111111a101111110110111111111111111010011011111111011111011
1111111111111111101101111111111110101011111011111101a1111111112202002100212121201122210122222111110111111110a110111011111010111111011111011011111111111111111101
0111101111111110100110010001111111111010111111111110a0111110111010221212121221122022112111022101111100111111a011111011111101110111111111101011001000011111110111
0111110101011111111010010111111110101111111110111111a1101101111111111111111110111111111001110110011111101111a011011101111101011001111111101101111101111111111111
1111111111111110101111111011011111111101110111011111a1101111011111111111111011111001011110100111111110111111a101101111111111111111111111111111111111111001011100
1011011111111110101101101111101101111011111011110111a1111111111111011111001101010110001111111111111101101011a101111110111111100011101111111111111100101111111001
1100111011111110111101111101111011110111111111111111a1101011011001111011101101100111111011110011011001111111a111111111110111111111110101111111001111001111011111
1110110111111111111110111111111111111010111110111101a1111101010111100111010101111001111001111010011111110101a111011111111111101111111111100111111111100010111111
1111111111111110111110011100111111111111101000111101a1111011111111110111101111111111111111111101111111011111a111111111111111111111111111111111111111111111001110
1111111011111111101111110111111100100001011111111111a1011111111011111111111111011111111011101111011110111101a111111101111111111111110011111111011110110101111011
1011111101111101111111101111111101111111010111101111a1111111111010111010111111111111111011111101010111111111a111101111110101111111101111111011100111110111101101