96 4
87 108
35 34
69 31
30 15
136 118
116 106
112 26
113 27
147 116
aaaaaaaaa0110112120011200221ab21111111a1111212011111011100aaaaaaaaaaaaaaaaaaaaaaaaaaaaaaaaaaaaaaaaa11111011111101101101101111110111111111110111101111110111101aa
11110101a1101102021212221122ba22210020b2112220111011110010a010111101111111111010111111011000111011a01111011111111111100110101111111111011110111101101100111111a1
11101011a1010110101111211101ab11220122b0202202011111111111a000101011110011111111111111111010111111a11010010111011111111111011101111110110100111111111111111111a1
11110111a1111100022121011211bb22121222a1221200111101101111a111111110101110011110011111111011100111a11101111101111111111011011001111100101011101111010111111101a1
10011111a1111012112121122121ab02011121b1212122010111111111a101111110110011110101011111011111111111a11011111111101111101111111010011111010101110101011111111101a1
11001111a1010112021211012020ba21020212a2111112111101111101a111110111011111111111111111111111111111a11010111111111010111111100011110111100111101111111111111101a1
01011111a1111110210112002220ba22020112a1110022011111101001a111111111111011111101001111010111011010a01101111001111111111101101111111111111110000110111111111101a1
11111110a0101011100221211211ab22112222b1012212111111111111a011111100011111111111111111011101111111a10111001111111001111110111110101011111101010111110111111111a1
01111111a0111111121011211220ab10100212b2021121011101001101a011011010110111110011001100111111111011a11111100111111010111110111101111111011011111111101111101111a1
01111111a1101110111010111212bb20111121a2212020110101111111a011101101111111111011111111111111111011a10011111011001111011111111111100110101101111111111110111111a1
11111101a1111102121121022221ab10212210a2110022111110111111a110110110111101011100111101111010010101a01111011111101111111111011111010111001110111101111110011111a1
01111111a1111101201121120101ab21121211a0202202011111111111a111010110111111100101110111110111110101b21211211111020121112211020202111110111111101111111110101011a1
11111111a1111100121112012122ab12010201b1021220111111111111a101111111101111111011110111101110111110b20222221220121021221102222022211111111111111111000111111111a1
11111111a1001101121122212121ba11022212b0021100111011111111a111001111110100111111111111110111011111b21220202020222101222222211022111111101111111001011110011111a1
10011111a1101110122021221212ba12221211b2021111010111111111a101111111110111110001111101111111011112b22021222212102222121120222221201111111101111101111111100001a1
11111101a1111001121122001201ab12210202a1211112110110101111a111111111101111010101111111111111101102b02122222121022121212212202222111101001111111111111001001110a1
01111111a1110011111202202202bb21111212b1211222111101111211b221121220022111121122101101111111111112b12202201222110221200022022220111111101111011101110111111111a0
11100111a1111110222122021122ab20112121b2010020111111111112b210011220112001010121120011111111111112a20022210222222020221120002212111111111111011110111101111010a1
01111111a1001101101212121110ab22120101b0100112111001110022a121002012101220201000221111111111111112b20120222222221222222002212221211101001111111111110111101011a1
11111001a1111101112122020212bb22222210b2222222110101112111a112211112220121222202112111111111111010b12021212122212222222222222220111110011011110101111111011011a1
11110100a1101111221120202222ab22002122abbabbabaaaaaaaababbb201222202120221122021121121101101100111bbbbbbbbbbbbbabbbbababbbabbbbbaaaaaaaaaaaaaaaaaaaaaaaaaaaaaaa1
10101110a1101011002112221220bb0212110202212222222011110111222212210202110222121212111010111111111222220202221222122121020112202220111101111111111111111101111101
11111111a1011112001120122212ba2022221022212022121120111001201111121222212212012212120111011001111122022211122222212120020222222211101111111111111111111011111101
11111111a1111010200020122222ba0122222212222222222201110212201112021200210110110112102111111110111002122221200202212222002022021211111111111111111110111111001111
11110111a1100110111201202202ba2122212221202111021201000121022121201222121012011110120101101111111211002222220212102210212122200211111100100011011011111011111111
11110111a0111112111212221222bb0022111220202222211010111110010102111221102120110221222111111111101202022220112110222220112211102111111111111101010111101111111011
11111111a1101001110102222120bb2202121011121212201221111002100221202011121022022221212011011111111021212022121220222122122122000111111111110101011111111111000111
11110111a1011112212022221100bb2121022202112222202211112122201010010011211011101200001111111010101122222122222212221222222222022101110110111111111111111111111011
11111110a1101111121212122212bb2222022221022200011010102121010022212122111200122112222011111110101021221210221012022111022120001121101110111111110011111111011111
11111011a1111112222212200202ba2222221222022122112221110222122010212221121211221210211111110111110110222221221201022220210212221220101101111101111111111111111101
11101111a0111112011001112020bb2212222021002222001220111121121222020222121221122222221111010011111212021022222222222100202221022021111010111110001001111111111110
10111111a0111111011012011201ba1011210121210222211001110211201221022221011022111221211111011110111222020222122211202002000222020011101111110111001110101110111111
11011111a1111111111112210101aa1020212012000220120021112222211220201212212122101221212111111111001212222100112200010222222222012221011110101111111001111111111111
11111111a1101010110121111111aa1220122221020021220210011021100101201001222111121221210111111111101202010110122202022222112222212211111111111111111111111111111111
11101111a1111111111112221211ba1100211100222012211110112021121221020112011022021002201101111111000122212022222220100222202002122201011111111111111110110111111011
10011011a1110111111020020011ba0121121120122212122211112211121121122111112211111121201110110111101122222222222220222202122002222121111111011111011111111011110011
00011110a1111111101112102120ab0222220111202011121211112112221222211202222012111122111101111111111111002121210222011202022221220021101111101001101101111111111111
11111101a1001111111021101222aa1111012122100120012020112021111222220022122211211111111011001011101222122202222211022221002220001220111111111001111011110111111001
11101111a1101101111111111111ba1201102121222222201201011211101222102120112202122220112111111111111002220222221222022222222222102221110011011110111110111111110001
11111110a0001111111112200211ba2112122111221102211021002121122222111001120012212122202111111111011020020222202212002221101102222211111100111111111111011110111111
11111111a1101110110111101102ba2221111102211222212121112111011010202011222210110122112110111001111012212220222221222222221220010211111111110111111011111111100111
11011110a0111111111122121120ab2221211221212211212121102122022201122121021211202221212110010101111222220222012202222202222200222211111111110101100111011110111011
10111111a1011101111102111220ab2212102112021120021221101211002221110110222110122222120111011011101111221111122121110021211212111211111111011001011111111011111000
01111111a0011101010120202220ba1221101010201111010211112210211111122021101121222022201111111111110111101010110111101101111110111111101111111111100101111111011011
11100111a1001101111122222202ab0212011101110211120121110110211212201111022202102022210111011110101111010111111111110111111101111101111101110011000011111111110111
01001110a1111110111112222211ab2212201110121210110221111012221112101122221101101011221111011111111111101111111011110111111111011011110111111111110010111101000111
11111111a1111110011112112212ab1101021212111011111220112122221222221001211211221010121111011111111111111111111111010100011111101111011111110111111001110011011100
10110011a1111011011001221122bb2100211022011112212101111011111111111011011111111111101111110011100111011111111111111110110110110011011101111100111111111010111011
11111110a1111101110110112201ab1102122122022212122221111101111001111111110101111101111111111111110101101110111111111111011111011111101111111111111001101011110011
11101100a0011110111112001121ab2212022110001222201201111101011110011111111011111111110101111111111110011111111101111111001110011111110110011111110111110111111111
10111111a1011011111011111111aa1111111110111111111110111110010001111111110111011010111110011101111110110111100111111111011111111110111111100110011111001101100011
11000001a1101011111000010111aa1111111011100111110010111111111101101111111110001111110111111111111111101001111111111101110011111111110111010100011011111111111111
11111110a1111011110111111111aa1101010011111011011111011101110111111111111101111001101011101111100111111111011111111101110111111111111111011111110111011111111111
01111111a0110011111111011101aa1111111011011110011011110111100111111011011111111011111100111111011111100111111111111111111111110111110111101011111111110110111111
11101111a1011111111100111110aa0110101111111111111111101101111101001111111111111111111101111111111111111111111111111101111111011011001101100111111001111111110101
11111001a0010111111111101111aa1111011111001000111111111100101111100001111011110111111111111111011111111101111110011111011100111010111111111111110111110111111101
01111111a1111110001001111111aa0111101011111111111111111111111011011111111111111111111101101101111111111111111011111011111111110111111111111111111111111101011101
01111111a0011111011111110110aa1111101111111111111100111111110011101011000111100111011001111111101111011111111111111101111110111111111111111011111111111111011111
10111111a1111111110110011111aa1011101101100111110111111010011101111101110111111011011111011111011110111101011011111111101111011111010111110011011101111111111111
11111111a1111001110011011011aa1111111111110111110110111111111111110111111010110111011001110011111011111101111111110011101011011111110111111111111100110111110111
11111111aaaaaaaaaaaaaaaaaaaaaa1110111111111111101011101111110111101101011101111111001101111111011111111111110101111111101111111111101011101111111110111101011111
00110111101111101111110111011a1111011110110111111101111110111110111111111111111111111111101111111101111111111111111111111011111100011001110100111110111111100111
10010001111111111101111011111a1011111111111111110111101011001110110110111011111111010110011111000011111011001110111111101111111111111111111011101111001111111101
01101111011111101111111100101a1111101101111011111110111111111010111111111011011101110010110111111110111111111101111011011100111110101111111111111101101111111101
11101101111111111011111111111a1110111111011110110011111111110111111101111111111111111101111010011111111111111111111111101110101001111001111110111010011111111100
11100111111111111111110110011a1011101111111011110111111111101110111111111110111111101001111011111111011101011110111111111111111111111010101111111011010011101011
00111011111111110101110011101a1111110111111111111111111101111110111111101110111111111111101111111111111111010101111110111111111111111111111111111011111111011111
10001111110100111111111111101a1111111111111110111101111111111111111110111111111111111011111011111001011111110101111000110101111110101111011111011111111111101100
11101111110011111111010111111a0111111110110110100011110111001110100111111111111111110111110101011111101111110111111011111101101101011111111111101101110111111111
11111111111011101111111111111a1111001101111101111111111111111110101100101101111001101111111100111011111111111111000010111111111110111111011101011100111001111011
11011111111111111110011111111a0111111100111101101111111101111011101110110100101111111111011111101111111110111110011110111101111111011111110111111011111111111111
11111111101111110100100111011a11111111111110111101111110111aaaaaaaaaaaaaaaaaaaaaaaaaaaaaaaaaaaaaaaaaaaaaaaaaaaaaaaaaaaaaaaaaaaaaaaaaaaaaaaaaaaaaaaaaaaaaaaaaaaaa
11111101101111111111011111011a11110111111111110111011101111a010111111110110110111111111101111110110110011111111101101111111011011011110101111111111111011011111a
10111110111111111101111111111a10101110101111101111111111011a111101011111110011111111111110101111011111111111011111010111111111111111110011011111111110111111111a
11101010101111111011101011111a10101111101111111000111110110a111101111110110000111111011011100100101111111110111111010110111011111111111111111101101111101011011a
11011011111111111101111111011a11101011111101011110111111011a110111101101011101111110111111100111111111101111111111001111101111101101111101111111011010111111111a
01111101111001111111101110111a10011011110111110110111111101a111101011111101101111111101101111011111111111101111101101111111010111111111111011011110001111110111a
11101111101011111111111111011a11100111111101101011111111111a111111111111101111101111011101110011011111011111111111010111110111011110111111100111110100101111001a
11111111111111111111111111111a11011111111111111111111111111a111111110011110111011111111111111011111101101111111001011111111111111011111110111011111111110111111a
01101111111111101101111011000a01111111111101101101111111101a111111111010111111111111011110001101110111111111111111111101110111110111111111111001010111111111111a
11111011110011110010011111010a11111111110110111111111100110a111111110111101111101111101000110010101111111011101111100111111111111010110110111111111110110111111a
10101111011111111011101100110a10111111111111110111110111111a011111011101111110111111110111011111111111111111101111111111111110110110111011111111111110001111111a
00111101111101010011111111111a11111111011111111111110011111a110011101111111111111111111111110011111111110111110111111011111011111111100101110110111111101111111a
11111110010010111111111011110a01011111111111101111111110111a111011101110111111110111111111111110010110111011110110101111111111111111001111111110110011110011111a
00110111111111111111001111101a11111110011111111111100111110a110101110111111101111101111111111111111111101101101111100111111111111011110111111110111111000111101a
11001111100111011111111101110a11111111111111111111111111111a111111111101111111111111001101111101111111111111111111110110111111111111111110111011110111111111101a
11011111111111110111111111000a11111101111011111111111101001a011111011011111111111111111011111101110111111101111111110111111110011111101110111110101101001111111a
01111111111111111111111111111a11100111111111110111011111111a101111001100100101110111110101111111110111110110110000010111011111111100111111111011110011111101100a
11111011100111101011111011111a10111111111110011101011110011a110001010101111111111111111111111111011011111110111111111111011110101101110111111111111111111111111a
10101110111111010111111011111a11011011101001111111011111010a111100111111111001111101111010110111011101111111101111011111111110110001001101111001111111111011111a
11111101111110111011101110111a10011111111111011011010111101a101111110110111111110001111111111011110111100011111111111111101011000111101101101011111101111111011a
11101101111110111111110111110a11111111111111000110111010001a110111111111111111011111101101100011111011111110020002201100201222110111001111011011101011111111111a
11110111111111010011111100101a01011111100111011001111111101a011111111111011111111101111110111111111101120211121222102221210210221010110110111111101101111001111a
10111110111010111101111111110a11010111111111011111101111011a111111111111111001111111101111011011111112010222112221121112121121120222111111100111111000111111110a
01111111111111111111111101101a01111111101011111101111111011a011111110111110011111011111111111110010010210022222201020220222211201220101110111111111011011001010a
11011110111111111001101111111a11111101000111011101111111111a001011111111010111111011001110101011111111211210111212220020220001212100101110100111111011101011110a
11001110111110111111111111111a11110111101011101111101101111a111011111111110111111111111111111110111011222221212120112201222002212202011110011100111011011111111a
10111101010110110111101110110a11011111100111011111100110111a111011101111111111010111111110111100111012200121211112221002120210202212111101010110100111110111111a
10111111101111111111111111101a11111101111110111111101110101a111010111011101101111111111111010101111111011210112222211111002221101102011110111110101111111111111a
11111110111111111110111111101a01111111111001111101101011110a011101101101011011110111111111111110110110212121222222211112110200202211111111101010110111010011111a
01101111100101110111101111011a11111111110011111111111111111a101111111111101111010111111111010100111112022122222202112022120211012101111111111001011111111110111a
01110111010110110111110111101a00101101010111011111111001111a100110111110110111111111111110111111111111210122222202120201211211011100122222220222120222122121021a
11101110111111111111001111001a11111001111111111111111111011a100111111111111101111111111011111111111112201221012022112102122102021111122111121112222112121021201a
11111110110100111111111111110a11111111111100101011011111110a111101111101101101111111111101011011111102212212122020212212221122122122212202022202102020100221120b
11111110011011111100110110101a11101011111101111110111011001a110111101111011101010111110110111111011011102121221212210011011222002212221202220102202201200201012b
01111101111000111111111011111a11111111111111011100101111111a011111111110111000101111111111011111110112020222112221221211202220022202102122212221212202220221101a
10111111110101110110111110111a00010010111111111111111111111a111111111111111111111010111111111111110110221102221122200221012021222220222122220122212102222212020b
11001011010111111111011111110a11011111101111110010111110001a111011101011101111101011111001111111111100012011222022112210111210221212222112211212220122210211222b
11111101100101110111111111110a10111111111110011101111011111a011111110111110111011111111111101111001112111111211201012212110202212022122201222220221122222021021a
11111111111100001110111111010a01111111111111011111101111111a111111111101111111111011010111111111111110211101222102011122021220221010022222221102020221111222111b
11010111101101100110111110110a11111111101110111101101111101a011111111111111111011101101011111110111101122122122121200212122022211220210222202222220220202210102a
10111111111111111111111110111a01111101111111100011110101110a110011111101110111111111110111101001111110000112211010112112110220022022102222202222221111222100211a
11011111111011111010111101001a11011110110011111111110111111a1111110111110111110011111101100110001111110110212122011221202212122122002001100210220122221211111112
11110111111111111111011111101a01011110010111011011110110111a1101001111111111101111110111111011111011102122101122221220010212222012212222220112202022000212202020
11111111111010111001111111111a11111111011101111101101010111a1111001111101101111111101011011101011011111210111212210211121002121011012121022022222222220021002112
11110101111111111011000010111a11011111101111011111001110111a1111111111110111101111011111111111111111112021122012111112120222021200222222202210212221221221122212
11111111101111111101101111111a10011111101111011101011111111a0110111110110100011111111110111101111111101211220120120122021220211022222222222021222222021122121212
11111110110111101111111111011a10111101111111111110111101110a1011111011111111011111111111110111011111112120110121211112212022222222220220212120022222202112012110
01111101110111101101111111111a11101010111100011101110111000a1101110111110011111101111111111010010101112101222002110101011212221212020222202121222122222221112211
01111111111101111101111011110a11111111111111011011111111111a0011101111111011011110111111111111111111010121121022202021222212201212201012022222220112102112021122