11 19
85 101
9 57
11 4
5 16
6 6
66 31
12 70
54 51
83 11
20022022010212122122121222011111111111111100010111101011011111111111211002120220a0121111122200212111111110a1111111111111101111111110111101100011111010110110111a
02022022222012222222022112211110011111100000001011110110001111101111020220112111a2221210212010120111110110a1101111011011111111110010111111111111111101110001111a
02220222101222122220221211210111101101110111110111111111111011111111220122002112a0122122110122020110011100a0111111011111110110111110111111010111110101111111111a
02220220222222221222020222011011111111111111011101111111111111101111122222211221a2222122121222120121110001a1011111111110111111110111111011101111111111111111111a
10022222000122022022122221111111110011111111111110101101100100111111221111220211b1220211122222111011110111a1111110111111011111110110111111101111111111111100110a
22221222220222202222221122211111111111111101011101111011111011101101021121021012b2121221112111112011111111a1111111110111111110111111101111111111111111111111111a
22022222222220222220222020011010111111110111111111111111110111110011112021111002b1222222221211102211111101a1111111111111110011111111111111101111111101110110111a
20222022201212212222201120011011111111011111101010101111111111111111220222010202a1102212222101210111001110a0111111111011111101110111011001101001110111111111111a
12222202211022022021222000211111111111111111111110111111111110011101212222111120a1121022022221200221101101a1111111111111110101101111101111011010111111111111000a
21222222120022222221002201210111101111111010101111101111111110111111010021202211b2021201111101202210111001a1101111101111101111111011101111111001111110111001111a
22222022222222022001101222111110111111010011111111101111111111101110012112112001b1221111012122111111111111a0011111111101110010111111011111011111110111111001111a
01220222120222122200220012001011110111111111111111011111011111111011011020111120b1021020112221011210111001a1101111111111111111011110101101111111110111111011101a
22022222102222211022222001111101111111111111101111011011111111111110101221221111a0122101210122111021111111a1111101111110101011111101111111011101111111111111111a
20102122222222222222121112201110100111100111011101110111111110111110112120020122a1222120111212001010011111a1111111011011101001111011111011111011111111100111100a
20122222202222012012202201011011111111110111111111111111011111111111210211102011b2222112211211120121011111a1111011100010111001011111111010111111111111111111111a
22022222212222220222221111110111111111111111100111011110111111110110112212002112a1212212121212011111111111a1111111101111111101101111110011111111110111101111111a
20222210102220222212212221201011100010011101111111110121211011111122120222220021b2202011122220111111101011a0011011010111111111011011111111110100000011111101111a
00222220221102121020211120111110111101110011111001112110122122002111221121102212b2022222112210120011111111a1111111101011111111111110111101101111101111011111111a
22202222220222202020111112111011101101111101111110111220102002212222022100012102b2100121122122121211101110a1111111111111011100101111110111110101101111111001111a
22020022122222222002001202201111111010111111110011102212111111202220111211222220b1122020211111201111011111a1011111011001011111111000101111100111111011111111110a
21222002222002222110221111101011001001111111111111022200021221212210121110110221b2021211202122112021111111a1111111101111111100111001011111011111011011110011111a
02222202212212022122121101110101111111111111111111021210011011211112222212212221b2122000001220111111101011a0011111111111110011111111111111111111111101111111011a
12112222022222101122211111111111111111110111111011120112211121222211112222220200a2221121210201202021111011a1111111101011111111111101111111011110111101111001111a
20122222212011222112211111111101101101111111101111112122120122012211122221021112a1112212220202212110000111a1110111111111111111110111001100111110111111111111101a
02111021010020122111210101110111100110100011110111122012112120122012222211202222b2001212100111110120110001a1111111111101011111111111111111011111011001101101111a
10111110101121211121211110011111110111111001111110121211022122122110021111022102b0211122221121212211111110a1011111111110111011111101011111111110111111111111111a
22121211110120022201001111111100111111110111111011101211100012222110202002220002b2122012200221121200111011a1110111101111110100111011111011111111111111011110111a
12011102111122202221111011110001111101110110110110110021120201222212201011102112b0111111111111001101111111a1101001011111111111100110110111100101111110110110111a
21011012020100121222211111111111011111110100111001122102201121212011102101112201a1111111111111110111110010a1001111001010111101011011110011011111011111110101111a
21010210012201121002101110111111111111001111111001011102212212001122202121221210a2111010111011111111111111a0111101011111011101100011011011110011101110111011100a
02112221222020001101111111010101011111110000111110112221121021022222002121212210a0111011111011110111101111a1111101111110101111111101011101111111010111011111011a
20112222021101220101011110111111110111110110011111122101222101111201121201222022a2111100111110111100111111a1111111110111101101111111111111111111111111011101111a
11110111000110111111011110111111110111100101111111122122011112111120022021222211b1111001111111011110111111a0110011011101011101111101111111111111101111100101111a
11111111101111111111111011111111011111100111111011122222120111011122010112210011b0110111111011111110111111a1111101110111111111111111100101111111110101011101001a
11111111111111111111111011111011110110110110111111120212102110010102222112202122b0101111011110110100010111a1111111110100111111100111111111100011111111011111101a
11010111111011110110101111111111111111011111011111122022120221001221010220222121a1110001111111111111111110a1111101111110111011101111101111111111010011110110110a
11101111011111111110111111101111111111112010222221121211220221112020220110212201b2110101111110110101111011a1001110111110111111000111011011110111111111111110111a
01111101101110101101101100011110111101120002211212012022222222222212220122112121a0111110101011011111111110a1110110010111110011110111111111111011111111001111101a
11111111101111111111111111111101101111112122120222112122022212222222220122002111b2111110111110111110111110a0101100111101011111110111111111111101101011111011111a
1111111111111101110001111101aaaaaaaaaaababbaabbaa1122122121200021002010201210222b21101aaaaaaaaaaaaaaaaaaaaa1111111110011111111110111110011011111011111011001111a
1011111111111101111101011101a1111110111201212122a2222001221120020212220211110200b11111a010111110111111111111111111101111000011011111011011111111111111111010111a
1100111111111110111010111111a1100111101111121210a1102222221202210222221022112211a01011a110111111110101111111011111101100111111111111110111110110101111111111111a
1011222122101221110220200101a1100110111110221121b1122212002222012212211200222221a21101a110110111111111111110111111111011011100101100111111111011101111011110011a
2102221102221010111212112111a1110110110220112102a2122202201012212210200112102011b00111a101010010111111011011110111111111111011111111110010111111111111111110111a
1201112120122122110221212111a0111111001111012220b2122022022222221112222102211211a11011a111111111111011101101100111110110111111111101111111011011111011111001101a
0011212212221121102012021111a1111110101102201010b1212211021100111020212001220221b11111a101001111111111110011111111110101111111010111111111110111110111101111100a
0222212121100222111111021111a1011101111211222212a1010122012022202122002222212001b21111a111110111110101011111111111010101110110111111011111111010111111111100111a
2010211111110221111100210111a1111111110121200222a1211121011202211122201111101110a11110a111111111111111101111111111111011101111011111111111111011111110110111111a
0112221100200201122122111101a1111111111212010022b0202121201010020112121110111111a11011a111110101101010011111101001111111011101111111111111111110101111011011011a
1012111121001122121021212111a1110011111110110211a2021221210211100010221110101111a11111a110111111111111110010101111110111110111111111010111111001111111110111111a
2112111001011120111102112111a1111011001222122111b0212101022111220002211111111111a01100a111111100101110011101011001101111011111111111101011101111101111111111011a
1112211212210211102121101011a1111111111222220111a0020222101122221120021111111111a11111a001111111011101111100110110111110011110101110111111111111110011111111111a
2202222212121101202012120101a1111111111021011111b0211201022000112221220111111101a11110a011111111010111111101111111011111111101111001111111111111110111111011101a
2211221222112112121011000011a1100111011222122111b2102022122102111112221011111001a11110a110011011111100100011111110011110101111011111111111110111111111111011111a
1222222221222202120112012011a1011111101011222121b2022012211112201221011111111101a11111a111101111111100111111101111111111111111010101111111101111011110111111111a
2220221220212222221222001211a1101011100112122012b1121002112121021101021001101011a11111a111111111101111011101111111111111111101111110111011111101111011011011110a
1222101022220012202212222222a1001101010201111110a1121122122212111121221100111101a01111a110111111111111111010111011010011111011110110111011110111000111011111111a
2220112111202212020112222021a1110011111202222212b2112121121102121212211111111111a10111a111111111110111111111111101110111111111111100111111011111100111111111001a
2202002222222221202201221212a1110111111202012211b1112012200112012002221111011111a11111a111111101011101111011111101111110111110101101111101111001111111111111111a
2202102120022222012222222211a1111011111120012121a1112211111112001110011111101111a11111a111101111111111111011111110111110011111011000111110011100011100011111011a
0202020112002022220122200222a1111111111102110000b1220112021020111012011111111111a01011a111111011011011111001111111011110111101111100011101111101111111111111111a
2122222200002212220220121121a1111111110112212102b2221110211211222021021101111111a11111a110110110001101110100111011111111111111101011101111111111011101111011111a
2212222222102222221212022111a1100110111202020112a2210012000122122001120011011111a10110a111111101111111011010111111111111111101111111001111001111111110101101111a
1200121012222222221012212011a0110111111112011010a0211111222112110001210111111111a11011a111111111111011110111111111111111011011111111100111101111011111110111011a
2220221102022222202021102210a1110011000111222211a2110102122111110001201111111111a11011a111110111101110110111111011101111111001111101111110110111111111100101101a
2121210002202221120122221012a0111111111011222022a1222111222110022122100111111101a10111a111111111110110111111110111111111100111111011101111000111111111110111111a
2010221012221222000122201112a1101111111112221222a1122120121212102021121111011111a11111a111111111001110101001111110111111011111101111101110100011111111101110111a
2222122122210022221020222212a1111111111111111110a0111001101111111011011011101111a11110a111110110111111111111111101101111111011111111101111110100111110111111111a
0202021222220202002221202022a1011101011111111111a1111011101111100111010101111011a11110a011011101011100111111111111111110110111111111111101111111011111101111111a
0122002211000122120021222021a1101111111111110111a1111001011011111111101111111011a11100a110111001111111111111111111111110111111100101011111110110110100111111111a
2221222122122122012212122210a1111011111101110111a1111111111110111110111110011111a01011a101111011111111111011111111111111001111111111111111111111111111011111111a
0211012122122221022021101210a1011111111111111101a1101111101101111011111011110110a10111a111111110110111011111111111111111111011111100111111111111110111111001011a
1022212222012201002022120111a1111011111111011111a1111111111111111101111111011111a11101a111011111111111010011011111111111111110100110111011111111110011100111111a
1210221220122112000120211011a0011111111111111111a1110110111110111111011111111111a11001a110111011101111101111111111001110110010011111111110101110101111111101101a
1120211112220120112102220110a0010111111111101111a1110110011010101111101011111111a10101a111111110111011111110111110101111101011111001111111110111111111111111101a
2011111121222001211101012211a1111111111011101111a0101101110111111111100111111110a11111a001110111101101111111111111111101111111111001011111111010101011101111011a
2121210121121120200022121001a1111111110111111110a1111111111111111111111111111011a10101a011111100011101111010111101101111010111111111101111111101111110111111110a
0122211212002121210112112112a1111111111111110111a1111010111100111111100000110101a11110a101011111111011111001001111111111111111101111111101111111111111111110011a
0100202211111211211020211121a1111111110101011011a0011010011111111011111111110111a01111a111011110101111101111110111011011111110011111111111111111111111110010111a
abbaaababaaaabbbbabaabbbbbaba1101110111010101110a1111111110011011011111111110011a11111a011111111101111010111101111111011010100110111011111111111011111011001111a
201121022100101112011222011200011111111111111000a0111110111111111111111011111100a11111a111101111111011101111111111011111110101101111111011011111111011111111101a
022112111212010212212010020101111110111111011011a1010101111111111111100110101111a11011a111011101111111111111101111111111111111101110011111111111111111111111011a
021012222110110122001010102000101000001101011110a1110011101111111010111111111111a11011a110111111110111111011101101111111111011111111110010011111101101011000010a
121121002121221000121200210101101111111111011110a1111111110111111111110111110111a01111a111110111111111010011011111110111101101011101101111110101110101111101110a
020212121222200212222202202211110011111111111110a0111110000110111101110101111110a11111a111111111101111110111111011111111011011100010110110111111111110011110111a
111210111101212222111121220111111011111101011011a1111111111001101010101110011111a11110a111110110111001010100100111111111101101110111111111111110111101111111111a
011111111111111111111111110101111111111111111010a0001111101111011111010111110111a11011a111110101011001111111101111011111011111101111111111111111111111111001111a
110111110111011111100011110111111111111111111011a1111111111011101110111101111111a11111a001101011111111010111010111111111111111101011111111110010101011111111111a
110101110111111110111011101110011011101111111111a1111111111011111111101101101011a11111a101001111111011101101111111001111001111101111011111110011111111011110111a
101101011111110100110110100101111110111011111111a1011111001111111011111111111111a10110a101011011111100111111111111110111101111111111111111111011111101110101010a
111011111101110011010110111011111111111111000111a1101000110111111111111011101111a11101a111101111111110011110110111111111111101111001110101111110111110101111111a
010110111111001111101111111100110111101011111100a1111111110111110011111110111011a01111a110111111111110111111111111001101111111111011010110111011111111001110100a
101111111111111111111100111110011001111111110111a1110011001011011111111111111000a11110a101011111110111010011111111111111101101001111111111111001111111001111111a
111111101110100111111111111111111011111101111111a1111011111101011011111111010111a11111a110111111011111111011111111111111111111111111111110111111001111111110101a
111111111011111111111011100010011110101011000011a1100010111111101111111011011111a01011a110111111111111110110111011101111111111011111111111111110101011111111111a
110111101111101111111101110011111011110101111111a1101110111111111111111111111111a11110a101111110111101111101101011111111110101111001111101110111010101111000111a
111111111111111011111110111111001101111111110111a1101111110111011101111001111011a11111a111110011111111111101011111111111101111111111111101100110101011111111111a
111111011111111111111111111111111111111100101111a1101111111111111011111110101111a11111a111011010011111111111111111110001111011111111111010111111111010111111111a
110110101000101101101111111111110111100100111011a1111111111111111111011111111111a11111a111111011111000110001111110101010111110011111111101111111010111111111011a
110001111111011111110110111111110111110111101111a1111110111111111111011101111111a11111a111111000101111111011111011111111110111111111111111111011001011111111111a
110101111110111111111101111111111111111111111111a1111111110111111110110111111111a11011a111111111011011111111101110010101111111011111011111101111101101011111111a
011001110100111111111110110111111011111111101111a0111111111100111011110011101101a11111a111111111011111011111111110111011101111111110100111111001111011011111111a
111111111111101111111100111111111111111111101111a1111110011111111111111001111111a10111a111111101111111111111111011110111101111111101001111111111111110111111101a
100111111111101111100101111111101101110101110110a1111111011011111111110101111111a11100a101111111100111111110110111111110011111111111111111111111110001101101101a
111010011111111111111111111110101011100111001111a1011111111111110111111111111110a01111a111110110011111111011111111111111111101011111011110111111110111111101110a
110110111111110101111010110111110111111010111111a1110110110011011111101111110011a10110a100111111100111101111110111111010111100010111110111101010011101111010111a
100011111011111110101011110111111011111111111110a1011110100111111111111111001011a11111a110001111111111001111010111001111110111111101011111111111111111111111110a
010111101111111101011011001111010000111111111101a1111111111111011001111111111010a11111a011011110101111111111111111011110111111011111110111110111001101111011101a
111100111101111111110001011001101110111111111101a1111111111101101110111111101111a10111a110001110111111100111101111111011010111111101111111011111011001111111111a
111111011011110101111110111111111000101101111111a1111111111111101111011111111111a01011a1111100100111111011011101101111110111110100110111111111111101111111111111
101111011111111110101111010110111111111111111101a1111101111111011110111101101110a11110a1101111111001111110010111111011111111111111001111110001100111111111111111
111111011111010111111011111111011111011111111111a1111111111111111110101111101101a10111a1110110010111111100111111011111111011011101101101111111011011111011110111
010001011011011110111101101111111111111111111101a1011110110010101110111111011110a11111a1011110111111111111111111111111011111101111110111011111111111111101011011
010111111110011011111011111111011111111111011101a1111110111101011111111111111001a00010a1111111111111111001111111111111101111110111111101111111111011111101101111
101101110111011011010111101011101111011111111101a1011101111111110101101111111110a01011a1111111011011101110110111100101101111111011111101011100111011011111110110
101111111110101101111111111111101111101110100111a1111011110111111111011111111111a10111a1110111111111111101110111111111111111110111111111101111111111000111011111
101111101011011111100111110011111011101111111111a1111111101111011110111110111111a11111a0111111111111111111101001110011111101111111111111100111111110111010110111
110011011101101111111111111111101110110111111111a1001011111110111111111001001111a11111a1110101111111110011110011011111111111111111100111111111111111011111111111
111111011111111011110111111111100011111111101110a1001111111110011101011111011110a10111a1111111111111111111111110111101111111101101011011111111001111001111110101
110111101111110111111101111111011111111101111111a0101111111111110111111111111111a11101a1111111111100111111110111011111011111010110111111111011111011111111011110