11 100
154 57
145 36
84 35
114 78
23 84
84 4
135 72
141 0
35 37
1111111110111101011101111111101111111111111101111111111111100111001111121122102221210011210101102112111111100100011111111101111122212121101222101110221201122011
1101111101111111101111111111111111110100101111111010011111011111111011101111022112022002111012112212111110111110111111111101100102212202211220210121212122202111
1111101111101111111111111111001110111101110111111111111111011110111111001210121202211122120112222101110101011101111111111110112120120100122210022221112211021111
1101111111111101111011111111100101100111001110111111111111111111111112122112200122111121001022222110111110111001011111011110110111211121102121101101011102021011
0101111011101111110111110111111111011010011011001110111101111011110112112111222222022212111102022221101111111110001101011111110221011221002100001111100220122111
0101010110111111111100111111111110111101011111111111110011101111000010022101011221210101011001101202101111111101111111110111110221120220011021112121221211110111
1010111011111011001111100111110011111101110111111101111111111101110112210121122211202201210201210121111111111010111111111010111221011212200110102221010010201111
0111010111111101111101111101111101111011011101111110101111111111011111112022111212210102222012211221101011111111111001110111112112201111112120221212110222220100
1111011110101110111011111111001110101111110101111101010101111111111111210002122110102210112121011220111111110111111111101111112112110111222212002202111011212101
1111111101110011111111110111100111111110110111110110110000100110111110111222201121121120211011012000111111111110101101111001110211211220012100122200001110202111
1010111101011111011110100111111111111111111110110111111101111111110110110111102201211100012212011210110011111111111001111110012222111201002110201202021222122100
1011111111110111101101111111101111010001000111111111111111101111111110221221220221111102122012112220111110110111111111100010102202112112121012202112221112121101
1111111111111111110101111000111011111111110110101011110111111011111112210221010012102212012200200121111101101110101111111111111222002221012221022102122222221101
1100111111111111111111111111111111011111110001111111111101111011110112221201222001002021211122021120101111111111011111011111111222120201010221120001011122110011
aaaaaaaaaaaaaaaaaaaaaaaaaaaaaaaaaaaaaaaaaaaaaaaaaaaaaaaaaaaaaaaaaaaaabababbaabaaabbbbbbaabaababaabbbaaaaaaaaaaaaaaaaaaaaaaaaaababaabaaaabaaaababbaabbbbbaababaaa
1111011001110101010111110111111111110110100110111111111110011111001111122122201212121212111111212222111111111111101111111111112221112120122001111101121210202111
1111111111110011110111011111111111001110111111111101111111111111111011202012212220211020222212222121111111111110111101110111111011111110111111111011111010111111
1111111111111011111011111111010011101111101111111110101011111001111110220211101121112201211211220121011111111110110111111111111111111111101110111110101111111011
0111110111111000101111101111111111111111110100111011111110101110111011122011110110121011011112001112100101101111101011111011011111111110111111011101111111111101
1111111111011011110111110111110111111001111011011100111101011101010111221220021222112200112121120022101011111111111111101100111101111111111111011111101010111111
1100111100001110111111111011011110111111111111111111110111111111101101221112122111222101221122222121110111110111011111001011111101111111111111110111111101000111
1010101111011100101111110111111111111111111111111110111011111101111110212212122212201222101122112020111000111111111111111010111111221012212210111121021010111021
aaaaaaaaaaaaaaaaaaaaaabbaaaaaaaabababbaabbaabbabaaaaaaaaaaaaaaaaaaaaaaabaaababbabbababababbabbaabbaaaaaaaaaaaaaaaaaaaaaaaaaaaaaaaabaabbabbaab2011200220212202211
11101011011101111110212100220120111202212010201122111101111111111111112111120110101120122221121122010111111011111111111110110111011102221101a1112112221021121020
11101111011111111111002020202112120121210220012011201110110011011010111122121020021010120020112211121111101011110101001111111111110121221221b2201112222210222021
10111010111111011111222221110211210111222222011211111111111101111111021201222102212212221111201110111111110111111111111011111111101121222001b1212112220012200111
10011101111101110101122211222221011111122202010121211110111111011101111101221011211011201222222220121010111110011110011101111111111200121202a1001121211011020220
11111110110111111011022022202012200222111211112222211111111101010100020111202012011212112221122101121111100011111011100111111010111100212201b1111011122201212120
10101100101111111110111222122100112021202211122112011111111111101111012121111110221112222212122001021001011111111111010111111110110221121022a1122012221112201122
11101110101111111011120021202020111222221121012220110111111110110011120111122112221212021022212111101011111111011011110110111111110002122102b1221011012202212222
11101011101011110111212100200000111222222111221220110010010101111101111221222221222010011122121220111111111111111110111011111111012202220222b2121112022021222222
11110111111101111111021102111122211222211012220022111011111111101111111100221202111202202000001021101110111111100011111111111110111102022222b2112201110122201202
11111110101001100111002012210222212222201111122220111110101111111011121012012211112110000101211112210111101101111010011111111100111220111221a2122111222111110212
01111011110111110011112002220221211122102201202102111111111110111111122112220001211101221211110021110111011111111010111111110110112022111211b1122222110010011100
11111111101111010111110212020012221222222000122121100111101111011001020110121110100100221021012020011110011111011111111111111011010022012011a2220112011212221111
11111011111011111101122022121120212021201211121011011011101111111101102111200111012121022121020201120011111011011111001101111111112221020002b1112222220211011222
11101111111111001111210120212022211210210121102222211001111000111111011112110122121001202211121211120111111111011101111011111111012022121200a2111122201110210010
01101010111011111101210222121112112210221120201111110110111111011011101002101221121112010001220111121111111110011101111111111100100121121212b1101211110021221101
11011011111011111110210112121201122202121111221122211111111011011111112122222221212101102021221021211110111111111101101111110011111221122222a2111211102200101110
11110111111101111111120210200221122102221110222122211101111010011111111111202120211022002201201121020111011101111100011101111010111201121200a2110212111121102212
aaaaaaaaaaaaaaaaaaaaa22221112210222120112221011010101111011111011011021112012122110111121222222120121111111101101111101111011111112210121202a2200221002122201211
11101001111111111111b21122122111101022221121002111010101011111111111112201020002112020121122112112111010111111010011111111110111102100100121b0201120211122121101
01111111110110101110a1122012112101121210001201200221111111000111111102201121022220111101222120112211aaaaaaaaaaaaaaaaaaaaaaaaaaaaaaaaabaaabaab2220111211101120111
11111111011111100101a2212122022100021120111220221221111111111001111112111201221211122210020021102222a11111111111111111000110011111121121221121221021210012122212
11111111111111111010b2202112111211211111210221122111111110111110101111121220210100021110021121221111a11111111111101111110110111111221010221202222022111122212111
00111111110111111011a2021212212201111122212010211220111111101111111002011022222012222221211211112121a11110111110011111011111111110122221210121221111012112200211
01111011011101111111b1022100210012022120221210201211111111111111111110111111212212222212211210211110a11101111111111111101111111111222210020201112211221011001121
11111110111101011111a2120212011101110211112112202010111111011101110112212210102120111012102220110122a01111111011001011111111111101202221212121022221011222102011
10111111011100111111b0201120201111211212121221021220110111110101101111211210201102122221011200222211a11111111111101111111111110101222222112222002212110211120211
11001000011101111110a1211122200021102211112101120021111011111111110112101212022121201020010120211121a01111111111010111111011100111121211112122222022222111101100
11111101111011111111a1121210210110102100022111222210111101111111101112221210120210222100111201201021a11110111111110111111111101111201112011210201212202011212202
10101111110101011101b1122112110102101021211220220211011111111111111101111011111111101100111011111111a11100111111111111100111110111012122212202122222221012021122
11111111101011111101b0001211111110122001212112211211111111101111111111101101101111111111111011111101a11111101101111111111101111110110111111111110101111110111011
11111111111111111111a1011111011111011110111110010111011011111101111000111110111111110101111001010110a11111111111111101001111111101111111111111111111111110101010
11111010111010111111a1111111111110011110011011110100110110001111111111111100111111101111101111011110a11011011101001111111101110111111110111111111111101111111111
01101110101011101111a1110011111111001111101010111111110111010111101110111110111111111111101010111110a11111111011111011100011111100011111111110111011110011110111
10111111111110110010a1111111111111011011111011111111110111111111011100111111101111111011001111111111a11111110011111111011111111011101111111110001111011111101011
10101111111111101111a1011111110011111111111111111011111111101110111011011101011111111111101111111111a11110110111011010012112102101001022112210120211201100110111
01111101111011111111a1111101000111110111111011001111101110111101010110111111111011101111111111111111a10111111101110100110111111122101001022121112202222111111011
11111111010011011101a1011011110110001110111111111111111011111110111111001111111111111111111011111000a11011111111101101112121012211122021122020000220111111111101
11011101111111111111a1010011110101111111110011111111010101101110111111011101011111001110110111111111a11011111011111111112121101220012101112122220211012111111111
11011110001111111011a1111101101111111110111101111011101111011111111111011111111010111011110111011101a01011101011111111111211201010112202222122011111101101100111
10111011111111101010a1111110001111001101111111111111111001110111111110111110011101111111111110111110a11011111101011011111011201221011102022010020211011111111111
01111011010111100101a1111011010111111111011111111111111111111001111111111111111111011111111111110112a12121100212211120110222020221211222120112010022122011111111
10111111111111011110a1011111111101111111111101101101111010110101010011111001111000100011110111111001a12111221221021221202220202122220111012111111212022111111110
11010001011111111111a0101001111011011111111110111001011111011111011101101111110111111111111111110111b10222022221212121122010022102220100101111012212100111111101
11111100110011010111a1111111111001011111100111101101010111101100001111110100111111101111111111111111a12000222001221211022012222221212211202221221221221111011011
11110111111101111111a1111101111001110111110010111111101111111111111111111011111111110100111111011112a20222102000020202022122100012210011212221220012122101101111
11011111110011111111a1110111011011110011111111111101111101101110111111111111111011110111011101111012b02201101212122210111222122121211211100122222001001111111011
11011011221211010112a2222222021110112120101111111001011001111110000111111101101111101110111110101111b12210112211222221212202222122102111222122110002100111111011
11011011221020221011a2122220102222212101111111101111101000111111111110111011101011111101110110101111b11201110211110201020220222202010110221101201221100011111110
10111111122120112221b1012120201112202221111011111110111101000111111111110111111011111111110111010110b10111122122210012222212010220222221211101112102220101011110
10111111112022101122b1011112112012111200011111111111110111001001110111110101111111101111111110111112a21222122110111212112010010212112121122101010101221101111111
10111011012221110012a1012221121120112121111110111110111111111110111011111111101011011110111111111110b00101112211212001102210212022222101212112222222121110111111
11111111001221120110b2012121202112222201101111111111101101110111110111111001011111111011110101101112b11112021222211112221022222212101211122111101201121111111101
11111011112211120122b2221221121212122221101111111111000111111111111011111111111110111111101110111111a01100212011121212121122010211212112210122201012120010111110
01111101111202121110b1120221210121121111111111111100111101110111100111111101000011011111011111111112b01110100112222101122111222212021202101222212122010111011111
10111011101102211211b1110221221000001121101101111111111111111111110111111110001110101101110011111101a21222020200221011202220112122221111212122111012011111111101
10111111121211110120b1220120111122112121110111111110110101110110111111111010010111101111111111111111a21222102212120221212001220222212211122122112001021111111111
10111011121211202212b2222212201ababaaabaaaaaaaaaaaaa011111111010100111111111111111011101011111110100a02112111022011211122120122022100122011111201222011011111111
11111111122120102221b2101211122b2021120111111111111a011110110111111001111110111110101101111011111011b12202211222212202112022022201121111211122212012221111111111
11101011211220001201b2101210221b1022211111110111110a110111110101111011111101010011111111011111111111a10212101112020112222120211222020212222121011201112110111001
11111011212211010202a1111111111b1012212101111111111a110111110101111001001101101110111111111111111100aabbbbaaaaababbbbaabbaabaabbbbabbbbbbabbbaaabbaabbbaaaaaaaaa
11101111112110212022b2211201011b2122022111110111111a110101110010111111111110111111111111111001111111111120121202202111102221222212211112122211110221211011011111
11111111212221011122b2112120012b1122122110101111111a111111101111111011111101111111110101111011111110122211122120201210102102120121212211012201000012102111011101
11110111210101012202b1211120122a1222122111111111111a101011111111011111011011111011111111111111111111210121211110210011112122221201012221100011122111210111100111
11101110222222221202b1201201021a1110122111011110111a111011110111111011101111111011111111111111001111201120011002220220122120222022020221122201110112222101110111
11101110101012001220b1101110211b1000111111010111111a111110111111111011110111011101101111111110111110100222110012010210212221122222021221220121012112011111111111
11110101020111020201b0022022122a0211101111111110101a111011111111110101011111011100111111010111011011122212212212121012211101110012111111111101111110010101110111
11110101222122122200b1210112222a2222020111011111010a111011011111011111111111111011111111111111111012001121212122101122122210111101110101011110111111011110111111
11010111011212121111a2120212112b2220121111011111010a111110111100111111101011111111111111100001111111211011022112010211120021222110011111011111111111111101111110
11111111222211222002a2012122221b1022111101111011011a101110111011111111111111111111111101011010000112110010011222120222212001210222111001111111101111001111111111
11111010012212222111b1201121122a1012001110111111111a111111110101110011101111011111111111011111101111110220212022220220012122110021110111111111010010101011111101
11110111122121212112b1220222120a0201021100101101111a001111111001010111010011111110111111101101101112111222211122112110121020211022111111111111111111001011010001
11100011112210212022a1220120122a2122201111111101101a100010010101011111001111101111011001111111111111110111111111011101011110111001111111111111101111111110011011
11111010101220120002a2120210111a0211222101111111111a110011010110111111111011101111111111001111111111111111101111111111111101010111111100101111111111111111111101
01101111121112202111a1100201102a2102111111101100111a111011111110110110011111111011101011101111010011101111010111101111101111111101111111011111011111111111101111
00110110210220220211a0222101222a1111112111011101101a110111111101101010111111111111101110011101111101111111010111111101111111111111110111111111111111100011011111
11110011021102110222b2122211021b1112001111111001111a011110110100011111101010011110100100110111101111111111111111101111110100110111111111111111111111110001111010
01011111212121120111a1111001121b0222122111111101110a001111011101111001101111111110100101111001001101111111101101111111011111111110111111110100111111011111110110
11011111111101111111a0011111111a1111001111101011000a001011111111110111110110111011111111101011011111010111101111111011111001010111111110111110001111101111111110
11111111111111111111a1111011010a1110110101111111011a101001111111111010111111011111111111111111111111101111011110111101111111111011111101111111111010111101110110
11011011011111111111a0111111110a1101100111111011011a110111101101111111001011101111111111111110111011111100111101101010111111111111111101101111011111111111111011
11011111011111111111a1111111111a0011111111110111101a111110010111111111111110101111111111011101111101111111100111110111010101111111111111011111011111111111011111
11111111111111111111a1111100111a1011111111101111111a110111011111110111111111111111111111110110011111011111111111110101101001011111111010111101111111110110111111
11011101011110011101a1111111101a0101011001011110111a111111111111111011111011010111111111110111111101000111111111101111100111111111111101110111110111110111101001
11111111111011111001a1011111111a0111111001111011111a110111100110111110111101111111111011111001111011111111110101111111011111111111100110101101111101011111011111
11111111110111110011a1111111110a1111011111011111011a110010111111011101111011111011110011111111111111111011111111111111111100111111111001011111111111111111101110
11111110111111101111a1111111101a0111101111101110000a111011110101111111110111101111111101111111000111101001111110111111111111100101110111111110011101111101111101
11011101001111111111a1101101111a1111111101010111111a111111111111000110111111111111110111111101111011111111111011011001001111111111111100111111101111111011110110
11111111111101110111a1011111111a1110111111111010101a111101101111001111011101111111011011011001011111111011111111011111111111101111110111111110111111111110111110
11011111101111010111a1001110111a1111111111111111101a111111010110111111111101011101110111111111111111111110111111110100111111100111111011101111111001011111011111
11111111101101110111a1111011111a1011101111111011110a111011011111111111111011111110011111110001111101111111111111101101111111111111111101011111111001111110111111
11100110001101111110a0011111111a1111001111101111111a111111111111101101101001111111101011001011111111111101111011111111111110111111111111001111111011111101100011
11001111111101011001a1111111111a1111111111111011101a111111111111111110110101011111001111111111111111111110101111111111111111111110011111101111110011111111010111
01110111011110111011a0101111100a1010111111011110101a111111011111101111101111111011101111101110011111111111011111111111111001111011111111111111111111011111111101
11111110111110111111a1111111111a1001111011111110010a011111110101111110011011111111110111111111101111111111011111111111111111110111100111111001011111101111111111
11101111110001011110a1111111111a0111110111011111111a101011111101111111110111111111110111011101111111111111111111111111110110110111111111101101111111110111111111
01011111001010111101a1101101001a1010111111111111111a111011110011111011011010101111111111111111111111101111111110111111101111011111111111110111011111111011110111
01111101111110111111a1111111110a1110111110111111110a111111101111101111001111111110011011111111111111111101111111111011111111110110111011110110010111011111111101