118 18
10 45
119 113
86 91
69 11
1 26
158 43
157 3
155 73
105 71
aaaaaaaaaaaaaaaaaaaaaaaaaaaaaaaaaaaaaaaaaaaaaaaaaaaaaab1221112211112112112b1022222022111111111101111111111111111100101110111111111111a1010100102121221122200222b
111111110101111111010110111100111111111010101110111010b2220111210112110122b2010210221111111111100011101110110111110111111100010011111a1110011120121220011012102a
011101100111111111111011111111011001110111010001111110a2200110202202111112b2022212111111111110111110111110111111111111111111011111111a1111101102100020122021111a
011110111011100011111011010001111111111111011111101000a1122211112111102222a0122112221111011110111111110111001011111101011101111111111a1111111000111111120112221a
111011111101111111010111111111111110111111111011111111b1111212022212120001b0012112101111001111011100110111011111111010111110101111111a1111001001212212001212101a
101111111111111111111110010111111111111101011111111111a1101211112111220111b1210011200010110111111111111100101111111110011110111111111a1101101000200121012122222a
110110110100111001111011110010111111111110110111011111b0210121122001212210a2211221111011110111110111110111111110001011111111101111101a1101111121222011022211022a
101010111111010101111111111110011011111111111110010001b2102102200122111101b2220101222111101111011111111110111111110110111111111111110a0011111121001201120122222a
110011111011111010010010111111111010111111111011101110a2001120110222000011b1111120222111110111110111011111111011111101111110111111111a1111111122221211221212120b
111101011111111011111111111110111011111000111011110110a1022222022221100122b2112221220110111010110111110010111111011110101111111111011a0111110101111212212121010a
111111101010111011111100101111101110111111111011111111a2112121112122111112b0221101111111101111011111111101111011111111101101101101101a1111111121102110211102112a
122212201221012111011111111011101111111011110101011111b2211000120211122001b1022212022001111011111011111111101111011111111111110111101a1111111122101021212122022a
121112121111111000101111110110011111110010111111111101b2101121111111122212b1211122102111011011100111111111101111101110111101110011110a0111111011221121222221121b
022121122110111121111011111110101001111111111101111111b0102112211111220201a1211021112110101101111110101111101111111111111111101111011a0111111102012020210112021a
220022001102221211011110111011101011011111111111111011b1012121111120121222a2212022110111111011111111101111110110101111111111111111101a1111111102222221222122211b
012012122212110011110111111011101001111111111111111111b2110021022112121122a2210122120111111011111101101111111111111100111111101100110a1100111112101222112100111a
111011122020210211111011101011111011001111111100111100b1222212021221122221b0221211111011011101110111110110101011111111110101001111011a1111111120101101111121010a
102112121100112211111011101101110111101111111101011111a2200111122212112010b1022221222001101111111111011011111011111101101111111100110a1111111121212022100220222a
111120121022120220111111001111011111111011111111011111a0100121111122122122b1212211001011101011111111111001111111111111111111101101110a1111110100101102212110222a
211010121211110000111011111111111111110111111111101111a1201011212211111222b2022122111111111101110111111111110101111011111111010111111a0111111111111111111111001a
022011001222212221111100011111111111111111111111010111a1212221210011002220b1211122110100111110110111111011001111110110111111011111001a1011011111111011011001010a
212120222022211211111110111101111111111111111101111101a0122012122221220121b0222102201101111011101111111101111111110101110111111101110a1111110101111101011011111a
122011112200212101101111111011111111111011111101111110b2221211021211121212a2111212121111110111011111110001111111011111111111111111110a1111110101001111110011111a
001120201201111221011011110111110110111110111111111111a0221212112101221001a2122102021101110111111111101111111111101110111111111111111a1110011011101111111110111a
012210202211221201111011111101111111110111011110111110a2010101021201002121a2121212102111111111111111110111111111101111111101111111111a1011111111101111101111110a
222221210210210021111101111111111010111111001101101111b2122222101112022011a2202112021111111101111110110111111111111111111101111101111a0011101111011111011101111a
220121112212200211111111110101110111011111111101011111b0220222201122222220b0110122210111110101111111111111110101110101101010011111111a1110111101101111111111100a
221121122110222011111001111011110011101011011011111010a1101111111111111011a1111111111111111110001111110111111111110011101111111100111a1111101110110111101111100a
210120111212102021101111001110111110111101111101111111a1101111111111111101a1101111011111111101111011111111101111100111111111111011110a1111111111122222211210022a
222011211021022220110111111111111111111011111111101101a0101111011010111110a1100111111110001111111111111101111111111101110111101111011a1111111110202211110202111b
111222112110222111111010010111111111101111110100111111a0111110010010000111a1111111011011110011111100111111111111111111111111111110111a1111111112122011111101112b
011121221021020221001111101111111000111111111111111010a1111110111010111111a0111110100010111110111110110100101111111111110111111011110a1011111110210212002211111a
110021201222021111111111010111010111011011011101111111a1010110101100010111a1111111101111101100111111011111111110111110111110110111111a1111111111102021212201212a
121012112022222221110111111111111111111111111111110111a0110101111101111010a1111001101111111111011011011101101111110111111111111111111a1111111112101121221221121b
202201111120001111100111111111111010110110010111111111a1111111111110011011a1001101111111111011110111111111111111011111110111011111111a1111011110212200211021112b
111222112202022121111101110111011111100111111011111111a1101111111110111010a1011011011101011101111111111111111111111111111111111101101a1111101111222020111012011a
212010121010101001011110110111111111001011111111111110a1101011011110011111a1110111110110111111111101111110111011111111110110101110110a1111011112010121100222212a
012222121012122211111110101011110111101111111111110011a1110111111111110110a1101101111111111111111111111111111110110111011111111111011a1110011112220002111112112a
201102222221111011111101111000111111110011111100110011a1111111101111011111a1111111101111111000001011111110111011111111111011011111111a1111011111121222101112222a
012120222122212110100111101110010001110110111101101111a1111100101110111101a1111111011010111111111101111111110110110001111011110111111a1010110012112110021111220a
122221112011011121111111101101110011111111111110100011aaaaaaaaaaaaaaaaaaaaa1011110111111101111100110110110011100111100111111011111111a1011111112000110022212221a
1211112212212112011111101100111110101110111111100110011100101111011101111111111111101110101001111001111111111111110101110101110111111a1111101101212112212120221b
1110111111110110111111110110111111011111101101100011111111110111111111010111111111101101111111001110110111111111011111010111101111111a1111111112222022122212122b
1111110111101110101111111011111111111101111011111111110110111100111101111110111111111111111111111111101110110011111111110111111011111a1111110111121012121212112a
1010111101110111111110111111111111111110111111101111111001111111111111111111110011011000110111111111101111011110111111110111011100011a1010111110101211222221212b
0111100111111111111111000111100101111110111111111011011111101101011110111111011111111111111011101111111111101111111111111110111110111a1011100102001210012222022b
1001011111011110011111101110111111111110110101111111111111111111101101111111101011111101111011011101111111010011101111101111101111111a1111111111212011200200112b
1111100111101111111111111100101100111111011111101111001110100101111111001011111011000110110111011101111111111110111111111011010111010a1111111012111102212122111a
1101111001111111111111100111111110111011101111111111101111011101101011111111111111111101111110111111110011111011111110111110110111111a1010001111221212000110211b
1111111111101111111110110110111111111111110111011101101111101010101011111100101111111011010111011111111101110100111111100110111111111a0101111111111011122120021b
1111111001111110111101011111101110111111111101111101111111111111011101100101111111111100100111010111111011111111111111111101111111111a0111011111120012212121102b
1111111010011011111110111011111111110011111101101111111111110110111111110110011110111110101010111111110110110110111110111001111111111a1011111101201122110012211b
1011011111111111111101111111111111111111111111010111111011101111111111000000011101111011110111011111111111111111111010011011110111101a1010111112220111122221220a
0110111101111111111111001100111001101111111111110110110111111111000111011111111111111111011111111011111101111101101111111111100101111a1111111111211121002001121a
1011111111111111111111011111110111010111011111011111011111111111111111111101111101111110111111111110101011001111101111101111111111110a0011110011111221220202110a
1011110111111111011010110101100111111101111111111111111111111111111111110000101011101111101111111111011111111111111011111001111101111a1111111112021201220111012a
1101010111111110111110110011111111111111011111111111100010111111110110111110111111111001110212022201120221220200221220021110111101010a0111011112222211122100201a
1010111111111110100111111111111111111110101001111011110111111110111111111111111101110111111111201122121002101222112221221001111101111a0101111111012001100121220a
1011111111111111011101100010111111101011110101111101111111011101111011110111111001110111110110011210111210211110010121212111001111111a1111010012202122221022221a
1111111111011111111011111111111111111011111110111011111011101011110011111111101111111111112212121122220000011210102121111111110111110a1111112122121111222022101a
aaaaaaaaaaaaaaaaaaaaaaaaaaaaaaaaaaaaaaaaaaaaaaaaaaaaaaaaaaaaaaaaaaaaaaaaaaaaaaaaaaaaaaaaaaababbababaaabaababbaaaaaabbbbbbaaaaaaaaaaaaa1111112122102122222122021a
111011111110111011111111011111011111111110111010111111101111111111011111011111001111011111222221222121002101011120102111111110111101111111100211211211021120112a
110111110111011101111101111111011110111111011111111111111111111110111111110011111111110111120211210210111111002211220211011001011111111110111111022121112121010a
011111111010001111011101101111100111111111110011111111100111111110111111100000111100111101220222012011212221212112022220111111111110111011012012212112112012011b
111011011111111100011101111111111111001111111101111111101011011001011101100110111111111111220111222122011222222201211201011101111111110011111121011122021112212b
111110011110111011110110111111101111111111111110011111011111111111111111110101111111111100211021011112022220021212020002011111111111110111110112112211122120221b
111110111001111100111001111111011111110011011101100111110100011111111101111011111111111110011122120000112210220211102211111111110111111111010020222001222112112b
011111011111101111111011011111111111011110100101111111111111101010111011111011101101111111212221212221121111101220221211110010110110111110112222121211111221212b
011101011101111110111111100111110110011111110110100011111011101111111011001111100001011110102122222001020211212121121212111111111110101111112122111122221201212b
011011011111101110101011101111101111101111110111101111111111010101111101111101100111011101122111021210012220112222001222210111111111111110111102010110202221211b
111100101111111111111111111101111111111111110111101111111110111001111111101111111101111010222111011210101001121112202020111111110011111111111121221200120112022a
011010111111100111101111111100111111011111011111111101111111111110101011001111011101111111111011221112220021202122220201111111111111001101011212112102210102011b
110110111101111101110111010000111110111111111111111011110011111010111111101011111111110111010112112200221111010102221110211111101111111011100122112101110112112b
111111111111011011011111011111111111111110111011111111011111011010111101111111101101111111102101121122212212012202121112210111011110111110112212222222100121010b
111111111100101110111111111111111111001001111111111111111111101010111001111110110101010111122201211112121022112210211211111110111110110111111010212221112202121b
101001110111101101010111111111001000110111000001101111111001101001111011111110111011111111000101121212200222212202012120111110101110111011011222022011110222221a
111100111111111111111011110101110111101111111111110111111110111110111111222111212121112111022122220221220012122221111221211111110111011110111102000201120202200b
111010011111111100111010111111101010111111111111110111101011111111110102201201221101212202221222022222112022122112111001011111111110111111111021111221222221222a
011111101101111110111110111001111111111111011001101110111011110110101112201121121221011001222122010022011202112122122011211111111111111111010111212012202202012b
101010011110111111100111011111011111111011011111111111111111101110010111210112211222102202222201221121221111202020101101111011111111011111111120012201111112121a
110111101011111101110111010111111111111111111111111111111101111010110111210022222222201202222202122012220221212210112011111110010111101101112211111101122221110b
101111011111111111111111111101111111011111010110011111111111101111111110221110002200011122222120202012120112012111120201111101111111111011012112212200122211221b
111111111111110111011100111010101011111111111111111110111011100111111112101111212222220112202212222221011211021222222102211111100111010101001122112202221122022b
110111111111011001111111101111101111111111111011111111111111111011111112202220211201111201222222110020010001122222111212111111110111100101010221122211201112011a
111101111110011011111111110101111111110111111111101111001111110101110111112112201220202212000021222222222212222222102221211110111110111111111110101110211201202b
111111011011111011111111110111101111111001101111111111111011011111111111112011200122100022202220010222212112112121012101111111110111110011010220120221121212100a
111111011011011111111101111110111111111111110111100011110111111111111112002012201112210100121122202211202201122002102222211111111011110111011222211201122112220a
011110110111111110111011111011101111111111111111101111111111110111111111102001212202100201212211222011111101011111111110110011101111110111112212101211102222222a
101010111111110001100111111010101111110101000111111111111110111111110011211211221221002022012112110102111111111111111111111011101111101011111212212201112121111b
aaaaaaaaaaaaaaaaaaaaaaaaaaaaaaaaaaaaaaaaaaaaaaaaaaaaaaaaaaaaaaaaaaaaaaaabbabaabab120122212110121212212111011111111111111111111101111100100111011111111110111011a
11111111111111111111011110111111001111111011011111110010110111111111011212212011b212022212202012112201111111111010111111111011111110101111111110101011111111111a
11111011111111011111111111110100111111111111011111111111011111100111111212211022b011122212110012011122111101111101111011111101110111110111110101111111011101111a
01111111111101110100111000100011111111111011111101111010111101111111111121011210a101221211201121121222101111011111101111101111111110101101101100111111111011111a
01011110111111110110110111110111001111111101110101111111101011010110011211221100a110221021111100111111010111110101111111111100110101101111111110101111111111110a
11011111110111111110101111111011110111110111101101110101010111011110111022120201b011111221102012020012111111011101111111111111110111101111111111111011011111110a
11111001101111111110111110100111110101100111011111111111011101001111011210001121b122221121201211022210111111011100010111111011011101101101111110101111111111111a
11110111110111100101111111111111111110110111110001111111111111111111101211022112b212101212122122001012111011111110111111111111111001110111101101110001001101111a
01111101110111111110011001111111111110111111110101111110111111101111110011122212a110021000202101200222011111111111101111111101010111101111111110110111111111011a
11110010110111111110101110111111111111001111101111111111110011111101111102111222a010202210212112022202112012212121202122211000011201211110011111111111111101101a
10110110101111111111111111101111011111111011110111111111111111110110111112212220b122200222222211212112112111120012122120200201012111222111011110111111010110111a
11110110011011011011010101111100110110111111110111011110111111111111111101101111b220212101001221022121111210002211021002102122111022211101111001111111111101101a
10111010111111111111111100100111011001111110110101101110100111110111111002001020b0101022222102112220201021122111110220221211122212120211011101110111010101111001
11111111111111101111101011111111011111111111110111111111111111011000111112212101b1012212020222021111211100212111020222221111111201111221111111111111111011111111
10011011111111111110101010110011111011011110111111111010101101111111111112211112b2201111111221111221001102110011122201211121210210120021111111101111111111111011
11101011101111111011101101001100011111111110101111000101111111101111111211200102b1111110021111222020101120122211011012001011112022112100101110111101101111111011
11110111011011101111000011111101111010111101111011111111011011011101101212211211a1121211012011201101011111011122222120101121022122201111101111111111110111111011
11111111101111011110101101101111111011110010111111101111111111011110001102002022b1212111011111220211101122121201121212221120122222020111111001111101111101010011
10111111111010111111101111111101101110111111111110111111111111011111110101111111a1111110011011111011101011212210111202120000101221211121110111111111111101101110
11110111111111111111101011111111111011111111111111111001111111100111011101101111a0110111111111111110111112121121200201121211121002110201111111111011111011001011
11111110101111011111111111111111111111111110111111110011111111111110111101101111a1111011111111111111111101110122002012121122212211221020101111111111011111111111
11111101111001110111111110110111111111010110111111011111111111111011111111011011a1111111011111010101111112220020212022112111202011121011111011010111111111111111
11111010110111011111101101011101011101111111111101011110111101111101111111010110a1101110011111110111111121210111112210211111212210011101111111111111110011111010
11111111111111110111010110011101111111111100111100110011111001111101101111100111a1111001111011111101111121001221211201111022200121111111011101101100011111111111
11101111111101111111111101111111111101001111110100100110011111111111111111111111a1111011011111111111111121022112111101121011221001112001111011111101101111111101
01111111111110010111101111101101111011111100011111110001110110110101111111101111a1111111111111111010011112010020111122011101000022121001111110011110111010011111
01100111001111110110111111101111111101110011100111110111111111110111111111101101a1111011111100111111111011021221102220022111122221202011111111111111110011101111
11011111110110111111011111110001111111111111001111010111110011111111111011110011a1101111111100111100010102200222122121202111112212222021110111111110010111101111
11011101101111111011111011111111011110110110101011111111111100111111101100111111a1111110011111111111100102112121222021220212121101111011111101011100010111111011
11110111101111101101101111010111110111101111111110111101110011110111111111011111a0111111011011011111011121112221222200212221210021102111111010011111011111110110
11111111111111110101111101101111111111110111111111111110011011111111000111101111a1111111111111011111110100111201112201220122021202112001111011100110011111111111