135 19
1 80
67 2
73 64
8 47
101 46
103 62
43 38
95 24
104 15
110111111101a1111111111011101111011100a111111011111122211002122110110111220121222101111102110121101110211211121011110111111111101110100101010011111101011110a111
111011101111a1111101011101111111101101a111110101111121200010121122110212122102000001111010221022111110021022121220110212111111101101111100111111111101111111a101
011111111111a0011111001111111111111111a111111111111100012011011012211111200112222101110112122101002111211002012010121112011101110111110111111110111111011111a111
111101111110a1011111010110111011101111a011110111110111120121112212102020212122012101110112111221202011202201021222201112111110111101000101111111001110011110a111
111111111000a0111110111111111111110111a111011111111101111102122002201010221222010221111112120022002122102210120222121211110111101111111111101111101101011111a111
111110111111a1111001100111111110110101a001101111110121221211121212212022221121012101011110101210121022212212021222121011111111101010101110011101111111101101a111
101101111101a1011111111100101110011111a100111011011122122212212002201211112122222221111011122211222211011121221212222220111101111110011101111100111110111101a111
111001011111a1101111011110111101010111a101111111101111201011002012022121222221010111111111122002211221111110121112212210111111101111111110101101111011011111a111
111010111100a1001111110111110111001110a111111111011121122212111122122111011122110110101111122222211111011221210121122012110011111111111011111110001111011011a001
011111111111a1111111001101111111111111a011111111011112220111120201020211211112112020201111220222221121200202122210222121110011101111111111100111101111101010a111
111111110111a1111110111101001111010111a111001111110111222111211200222011222011012221121122222121211011202220222110110112101001111111111111111110101111111111a111
111111111111a1101111011011101100111110a101111100011121202011001011220111012222112202112202212010022222021220220212101121111110110111111101111111111111111110a101
110111111011a1110111111111011010111111a101100011111020020202022220111222210101210120111122012212022212222110221121221102110111101111111111011110111111111011a111
111011111111a1110111101110001110111111a100100110111111112221012112022221011001221221011121220122012122212200121111021120111111011111101111110111111101101011a111
110111111111a1101111111111111011011111a101011100011112102212111022122110020212022220222011022112222000222022122102001021011111011111110111110111111110110111a101
111111111111a1111100111111111111111111a111011111101112102121121120222221200112212112000110202222222212120122210122011112011000111111110111010110100111111101a101
111011111011a0101101101111111111111100a111111111111122112022111212122122201121201221021212200222122211202002202201221011111111111110100110001111011110111101a111
111110011111a1011110111011111111111111a111101001011111111020222220021101112111022210021212221121210221212001022112101110111111011111111111111111011110111010a010
011011111010a1111100111111111101110110a101011111111111101110110111101011101010101001222212110022010220012022212212112211001110111110111101111111001111111111a100
000111111011a1110011111111111111111101aaaaaaaaaaaaaaaaaaaaaaaaaaaaaaaaaaaaaaaaa11100121111122221222102202212020222102120111101111111011111111111111111111110a011
110111111111a11111110101111111111111111100100111111111111111111111101011111111a10020021220222022201222211022221201221222111011101111111111011111111111111111a010
111111111111a11110111111111111011111011101111111110101101101111111111111101101a01022221022222222022210201220220101110221110111111011110111100101111111111001a110
011111010111a11111111111011110111111110111111111111111111111110111011110110111a12210122101222222201022222220220212202202111111101101111011101110011111101001a111
111111111010a01111011111111112022212111121111222112022122221111101111111111111a11120222020021000021201012211212201011110111111111111111001111011111110111101a111
111110010110a01100110110011002102111001111012201111020122121111100111011001011a02121110022222222221202020222221122210211111111011101110111111001111111111011a111
111110111101a01111111111111121221020212221111012221221100221101101111111111101a12221111102220022212222122222200022220210111101010101011011110010111111110110a001
110111101011a11111100111001101122111102222112112222110211021111011111001111110a10112221212122112102202011021021212212212110011111011101101111111111001111111a111
111111111111a11110101011101022121021211220122122210120111110101111111011111111a12120202122222022202222202021222121022221110111111111110111011111100111111111a111
111010011111a11110111111111021211222200201112111021202011111110101111111111101a10111122222102122022212112202110212212002110111111110111111101111111011110111a111
001101111111a11001110001110122111022221121202200211121201021111111111101111010a12221110112202222012022201111200202000112001011111111111101101111110100111111a101
110111111111a11111000111101120122220121012121200212210012020001111111111111100a12202112122222000122222002202210102022010111111111111111111111111111101111011a111
111110111111a11111111011111022121021222222112120102222222111111111011011111111a00121110212210222122202121122100122222011111111110110101100111110111111111011a111
212210221112a21022212012111121112110112202221100211210011201111111111011101111a12121222212222122021100222120200110221100011111011111111111111101110111111111a111
221211010121b22101010112111122110111111022120001121022200211111101111110010011a10120202221111122222222122222022121212110111101001111011100111100111000101111a111
121012202221a01022111221111112122111222112000101012211111221111111101101111111a12222002222212111211221201022221121212110111100101111111110111011111111101111a111
221220102111b11211222012100100122211212211221211200211111121111110011101010111a12201102022022012002212221020202022010011101101111111111111111010111111111110a111
210121012212b12221211011111012202021222221011221000021211211111111110111101110a00212112202222222020112122120122120212111110110010111110110111011100011111000a111
111211212220b12121210220111110121000221020122211121110210211111011001111110111a00221011222202222220202121202121111220111011111011111101110111101101101111101a111
021121112102b21121212221001120001011002210110221201120022010101111111111111101a02212210222001022222121200122222212122111111001101110011101101111111111111010a110
110101222122a02221122021111112001220211221220122222102001111011111011111110110aaabbaabbabbbbbbbbbbb222220022220201110111111111111011001111101111001100111011a010
112222111111a1201122120011111122221201222021112212111120121111111111110111110111111110001111212110b120111121222211111111111011111011111111111101111101101111a011
011220201102a1121121121211101000220212022121122100221222020111011110100111111111111001212220010222b011120011001212102101111101101110111111111111111011111111a011
111111210221b1200221202211110211212111122022211200101122222111011011101111110111111110101011202211a221221212101102120111111111111111111111011101101111111100a111
222200212200a1222021211111111212102211021111122212121110220110110111110101111101110101221111110211b211120222201012111111010101101011111011101011111111111101a111
210221021011a1111212121211111011222212212221211122122112222111101111111101111111111111111211112222b202111202222210110111111111011111011011111111111111111111a110
211221221001a1212222220211110111110211222112121210210221211110110101111100110111011111120122011122b012111002011120112101011110111111110111111111111110111101a110
200211212210b1120122122211112202202022111112220210111220002110111110010110111100110111021001120121b201221202210220221001110011111111000011101111011111111101a111
212020020112b1101022221211101211222220121212021112200020221011111111110111011101111111022122221112b222202201022211212211011110111111011110111111111111011110a111
112112102012a1211111222011111111222111122012112101212212122111111111000111111111110111112202220220b020221220222202120221111111111101111111110100111111111111a111
122211122112a2222112100111111221112210111010102002110212022222220101011001100112221112012212022221a212121212020022222111101101101110011111001011101011111111a101
121110221122b2112111102110110121101212212221021100212211212110122112212221212020120210221202221202b222111020202200221221110111111111111101111111011101111111a101
220211022100a1100102211110110212211221110222201122120122122012122101121121201011000212221020120222b120211200220002222120111101011111110110111101011011101011a110
122101211112a2011112211111011011012222211210112112012112122220112212212121212110011121222202012202a222222012121221121121101101010101110110111101111111011100a111
112202112111b1212222112011112201212121210220110211210121122221111201222002011222201222220202222002b212002212212121212111101011001110111111111010110111111100a111
222021111201b2211202212211110111111111111111110111111110111121111210012101102112011200222222122222b002022221222021022221101111111111111010001011011111101111a111
211120112010b0121122121211010110111111111011111011111101111012112012210102112112222211222222222202a111022020222022202201111111010111111110111110111111100111a100
220122111221a0122011222211111101111111011111011111111111111221112201021110122111212222122122122222b222200222122022011001101111110110111111111110111101110101a001
120021201200a2111022121211111111111111111111111010011111112020111111221202112022012102202002221222a102210220220012220011111111111111101110110001110100111111a111
100211211121b2211101111211111111111111111111011010110111111122112221221122111111210202022122001111b022212022222120222211111111111111111011111111101111111111a101
112110210202a0120222211111111111111101110111111111111011102111220022222022022002211120222222211220b120112021121212222021110101111111100101111111111111111011a110
211222021022a2121022120201110111111101111100111111111111110112211212121111011222011100212101220122b012211212202221221020111111110100001011111111011111100111a101
001110220021b0112202111001111111101111101111101111110011111211122221102211011111122121010201222212b021121222222201120221011101111100111111011010111111110010a011
100120211201a2022222122210011101011101001111010111111111102021212221110221211121021110112001112221a222211012021112122111101110110110011111110111011111001111a110
111101010111a1110111111111011101111111111111101110110111111111212120121100121122210201102222212221a120201220222210221211111011011011110111111111010111101011a010
110111011101a1110111110111110111110111110010101111110111012111112221201222101211011202122212012012b211201012102122110111111111011111111111011111111111111110a101
111110111011a1010111010111011011111111111101101111111011011211100112002112212102211102212212011112b221112201211211222001111111111011111111111111111100110111a101
111110011111a1101111111011011111110101111110111111111011112220102200020011210122221022220111021212a222110022000221122121111111111010111111111111111100100111a111
110100111110a1101110111111011111110010101010111011111011110112111212212102101202102221120022221212b222111021121112122211010111111101011011111111111111111111a111
100111111011a1111111100011111111111111101111101010110011000111210122211121211211021211111101212111b111222120122221221211111111011111011110111101011101101101a111
111111111111a1110111110111111110110111101111100111111111010212112201121212022212101210112122021112a121222111101110222100111111111111101111111011111110111111a111
111111011001a1111100111111111110101111111111101111111111002012220222222121111101110122200020212011a120210202112221221011010101111111111110111000101000111111a111
101111111010a0101101110111111110001110101001111010111111101002122102102111001112121121121011222221a210122002121202122121111101111110011111110110110111111111a111
101111100000a1111111111111110110111011111110111111110111112200210222111221221122222220210211112201b121222021111121210121011111111111111001110111111010111011a111
011011011111a1111111111111111111011100111110111011011101012210212210021212212121201221122201120211b220111102212020210211110111100110110010011101101111110011a110
011111001011a1111111110111101111101111101111111011111111110112220202002210112121012110122020122022a210111012102011122201011101111111111010111101111110111101a101
001110111011a1101111110110011111111110000001101110111101111120101122212121102110211112221222222010a200101120102212200011110111101110111111111111110111111111a110
101111111111a0111101011110111111101100111011111010111011112220212211222111010101122111120222100211b201212121202202112221111101111011110011010111111110011110a110
111110111111a1111100001101111011010111110111111110101110102222111112212111120212022222221202121112a212021100112221210101111101111111011110111110110111101110a111
111110111111a1111101111100111100100111110111110111111111110112212121021011210110112220221111010110a110000100111101111110110111111111111101111111111010111001a111
110111011111a1011111111101011111111111101011001110100111001121112220211222001011221221101111011010a110111111111100aaaaaaaaaaaaaaaaaaaaa101110110111110100110a111
010101111111a1111111111101111111111111111011111111011011110111111010111011111011111101111111011100a111110100111111a0101110111101101111a111011111101111111111a111
111111011111a1011101001101011011100001101111111011111111110110101101011111111011111001111010111111a111111111111001a1011110111110101111a111111101010110111111a111
111110100111a1111111111011110101111111111101111111101111110001111111100001111111110101111110111110a111011101111111a1111001111101111110a111111111111111111111a111
111110111110a1111011110101101011111111110111101101111111111111111110011111110111101111110111111110a111101101111111a1111100010111111111a111101111010111001011a011
101111011011a0111111101111110010101111101011111110011111101111001111111111101010110110111111100101a111111111111110a0111111111111111110a111111111111100111101a011
101001010101a1110111111111101101011101101111111011111111101111111111111011111100110111011110111111a111001111011111a1111111011111001111a011111101111111111110a111
100111110111a1111010111111011111011101111111101111001111011111111010110111111011011101111001110111a111111111111111a1010111010110111111a110110111111011011011a110
111111000111a1111010110110011111111011111011111111111111111111111111101110101100011111101101011111a100011101110110a1101111011011010011a111111111101011111110a110
111111111111a1111111110011110100111111111111111010111111111111001010111111111111111111111011101101a111111111110111a1111101111101101101a111111111101111011111a011
111111111111a1100111111110111111100011010111111111001111111011111101010001111011111110111111111111a111110111111111a1000101101011011111a011111111110110011110a011
100111100100a1111111101111111110111111011011011110111110111101111111110111101111111100111110010101a111111110111010a1111011011111010111a111111111111101011111a111
111111101111a1111111111101001111110110111111101111111111111010111111101111001011010101001111101011a101101111111111a1011101110111111011a111101111111111111111a101
111111101111a1111111111111111110111101111101011011111110010111110111011111101111011111111110101111a111010111111111a1111110011010101111a001111111011111110010a101
010011011100a0011111101101111111111101111101111111110011101111111111001111100111100100111111111011a011111110111111a0111111111110100101a111011111111111111111a100
111101111110a0101101111110111000111111111111101110111111011111111111111111111001111110110101111110a011111100111111a1111111111101111011a111110110111101111111a111
111111111111a1111111111110110011111110111111101101001111111011111111111111111010110111111110001111a101110111001111a1111110111111110011a110111011101011111101a111
111111110001a1011110111100111111010111111010100110111111011111111111111111101110101101111111110111a111111111100111a1110111111110111111a111111010111111111001a011
011001111111a1011111111011111110011111111111111001101011111111001111111011011111111111111111111111a111101111110111a0111011111111011110a011111110111111101111a110
101010110111a1011011111111111110110111111111011011111110111111100111001110101111011101111111011101a111101111111101a1011110111111011111a111111101101101101111a011
111110111110a1111011101011111110111110aaaaaaaaaaaaaaaaaaaaaaaaaaaaaaaaaaaaaaaaaaaaaaaaaaaaaaaaaaaaa110111110111010a1010111101111111110a001111111111111110101a100
101101111000a1111100110111101111011110a110111111110110010101111111110111011111101101111111110011111111111111111110a1111011111101110111a111111001111111011111a111
111111111111a1110111111111111111110111a011011011111111111111111111011111100111111111100111111100111111101111111111a1101101101111110111a111101100111111111011a110
100111111111a1010111111011111101111111a111111010100111101111111101111111111111111011111110100101110111111101111111a1011011111111111110a111111101101001110101a111
111011111111a1101011111011111111111101a110110110111101011111011111111110111111010111111001001101111101111111001111a1101010110110011101a111111111111111110111a111
110111011101a1111101110010111101101100a111111111101011111111111111111111111111011100111111111101110101110101110111a1111111111111111101a101111011101111111110a111
101111111110a1111101101101111111111111a101100110011101111011100111111111011111111111011111111111110111011111110101a1111111111110111110a011110111111111111111a110
100000111111a1101101010110110111101101a111111111111100111111101111011000111111111111101110101101101101111110111101a1101010111111111101a110111110011011011111a111
100111111111a1110111111101110111101111a111111011011110110011010111011100111011011111001101110101111101110111111101a1111000010101101110a111111110111101110011a111
111111111101a0111111100101101111100111a111100111111110110101111110111011111111111111111101001111111110111011111111a1111110111011111111a111011001111111111111a011
011111011111a1110111111111111011111100a111011011111111001101110101111011111111111111101100011011111011110111111111a1011101101111101011a111111101110011111111a110
111010111110a1110111111110110110111111a100010101011100011101101001101111111101111111111111111010111111111111111111a1111111101111111011a101111111011111001111a111
111111111101a1111111111100111101111101a110111101111111011111111001111111011101111011101111110111111111011110111110a0110011101101111111a100111111111111111110a111
111011111101a1011011111111001111110111a111101101111111110011111111101111111010111111101111100010101111101111110111a1111011011110001111a111111111011111111011a100
111111111101a1111111111101111111110111a111111011110111111011101111101011100101011011011111111111111011110111011111a1111111000001111111a111111111111110111001a011
111111111111a1011100011110011110111110a001111101101111011011011111111111111000111111111111111011101101010111100011a1011111111101110111a011011110111011111100a100
011111010111a1111010111111111110111111a111110101111011111111111111111111111101111111001111111011111111101111110111a1111111011111110111a111111011111011101111a101
111111111011a1111111111101001110101111a111111101101001011111101011110111000010110111111111011111110111110011111111a1111111111111111111a111101111111111101111a111
111111110111a1010111111101001101010111a111111111111111011101111110111111010101111111110111111101111111111111111111a0111111011111100011a011111111111111111110a111
111111011111a1111111111111110101111111a011101111111101101110111111111101111110111011111111111111101111101110011111a1111111101111111111a011111110011111111011a111
111011110111a1101110011101111111111010a111010101111111000010011111111001100111111111111100101111111111110110111111a1111111011011000011a111111101111111110111a110