10 112
150 8
57 42
0 118
50 66
113 103
138 26
98 24
85 113
15 69
10101111111111111110101111111011111101110110011111111101111111111111111100100101111a1111111111111111111a00111101101101011111101111111011111110111111111111111101
01111111111111011110010111101011111110101011110111111111111111111101111111011111010a0110111101011101111a11011111111111101111011111111111111111111011111011110101
11111111111111111100111111111111011001101111011110111111101111011001111111101111111a1111001111111111111a01111111010110001110111111111111111101001010101101101101
11111101111101111110111101111110111111001011110111110011111111111111111010111111111a1111111111101111111a11111111111111110011100111111111010101010011110111111011
01001111111010110111111111011110011111110111111101111111111001111110111111011011111a1110110111010111111a11111111111101110011111111110111011000111111011111111111
01111111110011111101111101111011011101111011011111101011001011110111011110111101111a1101011111111111101a11111111111100011111010111110111010101111111110111101010
11000000011111101111111011111110111011111111110111111011011110101111111111111111110a1111101010111111111a01111111111111110101111111010011011111110111111111011110
01101111011111111111011110111111111111111011111111110111010111101110011111111111111a1001111110001111011a01111110110111100111111001111111111001111011111110011001
11111011011011110111111011111111111111111111111111011101111110011001011111111111111a1101011101111011111a11011011101111111111111111111111111111111111111111101111
01111101010011111111110110111000111011011101111110100001111111111111111111111111101a0221122201222101222a22202120211011100001110111001111111111111011111111111111
01101110010111101011100001111101111111111101100111101111111111010111111111111011011b2221101111212221111b01210020211111110111011110111111101111111110001111010111
11011011111111011111010111111110111111111010111111111111110111110101011011111111011b2222002220222121112a10121121121110111111121122101210110bbbababaaaabbaaaaaaaa
11110101111111111111101011011101111111010111111111101111111111111011111101111111111a2100222021112211121a10102201001110110110102011121212121a2111112210221111010a
10111111011111110111111101111111111101101101111101101101011111111111111110111111111b2210202102201210212b01020121211111111112110202221021112b2221222112101111011a
10111111111111011110111111011111111111111110111111111111111110110111101110110111111a2122112222212221212a22012211221111111111020221121101021a1121102121212111111a
11111111111111111111101011111101111101111111011111111001111110111110111101101110101a2011001220111102212a21212122011011111111120102210221201a1022010101221111011a
11110111111011011111111111101100111111111111101101101111111111001111110111000110011a2022221122012222121a10012102221111011101220122112022102b0011101110211211111a
11011010101110111111111000111110111111101110110101101101110111011111010111011111111a2012220011022222212b12111100221001111110222120122121212b2222111201201201111a
11111101111111111111111111111101111110111110101101101111011101011010100101101111011b2212201010212022121a22211012020111001112122111120221100a2222111122222011111a
11100110111011111011101111011011110011111101111101101101101101110011111101111110111b1112201101120002122b11102221121110100102102122111112121b2210222211112211111a
11111111111111100111101111111011010011101010111111111111100011011111111100011011101b1112202112222122010b21012220201101111112122212021111222b0101122011211111100a
01110111111010110110111111111111111100111111010111010011111101111111101110001111111b1121112220211112222a22102102111111111112221022222011101a2102121020212011111a
11011111110101111111011111111111101101110111111101111101111110111101010111111111111b0101220111202112111b22120221120101111111101211212212122a2100122212221111011a
01011101101111111110111111111101111101101011111101111111111011100101111111111010101b1112112221121111200b11012021021111100112221021111120002b2102102220102111110a
01111110111111110111111111101100111111111011111111111100111001111101111111111011111b1112201110121100221a22221221121111101011222120002112122a2111212212222111111a
11101111011100110111110111111110011111111110111111111111111110111111110101100101110b2212202200122222122b01210022221110111111112121122121121b2121120222111111110a
11111110110101010101111111001011111111101110110111101110101100101100110111111111110a2122122112111221202a11212221021111101100221022220212212a1111121222000011001a
10100011011110011111101101111111111111011122022102101111222111122011110000001111111b2110200222221121122a22220021221111111111121222101110112b0211020200112211111a
00111111110111000111111111011111010011110122022122111221112201212221211201111111111b1022010012210001021a11112012011011011112120110001200111b2201120212111211011a
11110111111100111100101111111111101111111120112222211001001110220112220121111111101b2002201220011211121a21011200010111111012012222221200000b2022111222211211111a
11011101011101111111111111111111100111111111110211011021002201101120012221101010111a1012222220112122121b21211101021111110102221211112011111a1122002210222111110a
11111110101101111111111011111011111101111110112211200202210021011111220101111111011a2012021202201202222b11112221201101100111012101221021101a0222212101011211011a
00111111111011111111101111111110101110100021211222102212021220120111211201111111111a1011112122222201122b21021012111111111002012111102202212a01212012102222110111
11101111111111101111011111111101001111001121021112210111211201112222122121111111101a2122222002200101121a21022112201111011010212212022120110a22222121122221100111
11111111001111111101111011110110110111101110111010101111221212110222212211111111111b1211122002222221021a21022112221101111011121122122222122a12111211120201011111
11111111110110101111111111011110111101101112201202121222022021221122212111011101101a2121110200210121212a12212111120110101111110100211211121b21111121021121110111
10110111111011111010111101011111110110110010121112122222211220222202222221101111111a2112202102001222022b22121101201011111110021112112110111a22122222212222111011
11011111110111011111011111111101111111111100200102210112222021021112212101001011111b2121021011102112211b00000110200111110110001100021120220a11221220102021101111
10111111111000111111111011111111111110011102002122121122022201101122101001111011111b1212221101220110111b11020012121111111101111211112212010b12010102102102011111
11011101111111111111111010111111101111111100122222122112120100202121220221110011110b2222112211210212211a11212211111011111112111222112211120a12212012112212011111
01111111111001111111011101111110111111111122111221121122122220220212120001111111111aaaaaaaaaaaaaaaaaaaaa01111111101101111112120211012212202a21100102112111011111
1111111101010111111011100111111110110111111212001222122202022201201121022111111111011111110100110101110011111110100100101102110011121222210a22201121020112101111
1010110011011111111101111111011111110011101211112101212211222110121211212111111111111011110111111111111110011111111100111111111011100011010a01111011011110110011
1111110011111111001101111111110111011001111221222121122112112121022110022111111111101101011101010011111111111111111111101111010111111101101a11110101011110111101
1111011111011111110101111110111101111111011212120111100202212200121221121010111111111111110111111110111111111111110111111111011111100101110a11111101101111111101
1111111111111011110111101111011101111111111121012212111202222120121111220011011111101111111111111011001111111111110101011111111111011111111a11110111011110111111
0101101101111111111011101101111111011101101112111122012101202202121120111111111111000111011111101111101111011110101111111110110111100111110a11111010101111011111
1111111111111011111111011111111111111101101022222222220222011120212201102111111101010111001101101111010111111101111111010101111110111100111a11110111111000111101
0111111111111111111111111111111101111000111220112222202020210112102212102111111111111111011011000011100111111101111110111101110111111110111a11111110110011111111
0101111111101101111111111111111010110111012112221110120111011222200221100101011011111010010111111110001011111111111111111111001111110111111a11010111110111111011
1011101111111110101011111101111111111111012112212210222111211121112212021011101111100011111111111111100010111101111100111111111101111110111a01111110111111110100
1111111101111101000001011011001111002122122211222101020122220122002021111100111101101101111111111011110110111111011101111111111111111011111aaaaaaaaaaaaaaaaaaaaa
1110110101101111111111111111101101112111202220202122022222222002011012201001111111111100111101011111111101111111011111111011110111111111111111111101011111110110
1011101100100111111111111111110101022022012221222020222122221222212221011111101111011000111001101111101111111011111110000011000111101111111111111111111111111111
2112212112222011112210112222212001121101101020022222122221221222222012212011110111011110011111101110111111111111111001111111111101010111111111111111111111011110
1220012120112210012110102112002110111212220212200222122222022222212102212111111111111111111000111111111001110110111011111111011111000110011111101111111101110101
1022022111022211201022200022021111002101202222202020220110212222222110110111111110110111111110111111011111111011001111111111001111111111111110101111010111111111
1201221221201122222021121121222010120211102221022222201012222220120201222111111111110101111111110000111110111100101101011011010110011011100111101111111011111111
1120220201220001120120212112012110021212122221122201112101011120100111111111111101101001111011110111001011111111110111111101110111111100000101101001011011111110
babbbbaaaabaabbabaaaababaabbbabaaaabbababaababababaabbaaaaaabbaaabaaaaaaaaaaaaaaaaaaaaaaaaaaaaaaaaaaaaaaaaaaaaaaaaaaaa111101111111010111010101111111111101111101
022111201121212011212121212121211110221122111202110102012110012202111111101011111111111111111100011000101011101111111a111111111110011111111110111010110111111111
211122012111221211111222011210101011202110112220120220202122122110110111111111100010111111101111010011111101011111111a111111110111011111111111011111111101111111
010221201010122121022212212222110111021222222121222202111200110122011111110111011111111100110110111101111111010011111a101101110111101111110101111111011111111111
121201110010112202201121120022111011111000111022202200202211112112111111111110111011111110110011111101111011101110111a111111111111110111111111111111111011011111
221101221112210222012121220010211111021122220200001201222211211111101111111011111101111111110111101111111111111011011a111111101011101100111111110110101111011011
022212112021222112121112202210011110002111121210201212010101220111111111111011111110011101011111111111111110111110100a101011111111011011111011111101110111111001
222221002222201111021112201111101111110121221210202021012102111212111011111111111110101111000111011111101111111011110a011111000110101110101111111111001011110011
220111111210012100112211110222211012222122120212021121111111212010111111110111111111111111111111111101100110101111111a111111111111111101011111100111011111111111
020112002220212112001111122202211112002121112111011222221020022021101101111110110111011011111111011111111111110001011a001111111111111101111110111101111111111111
111212212121112022212210110121211112221200202200112212101002211112111111111111111101111011111111111111111111011110111a111111011111111110011101111110111111111111
021221100220102101020122020022110110220122122102122211112110221121111101110111010011111111111001111011111111111101101a100111111000111011111111101111111101011111
210020101212120112212220121212211012001210021102121222211210022101111010110111010110111101111111101010011110110011110a111110111111111111010101011111111111111111
122120112212112011121202222011001011210021112121012121222221222221111011111100111101110111110111010111111101110111111a111101111101101011111111111010010111011011
012211111020111012202120210122211111122222122211212222111111220112010101111111111110111101011111011111111111111111101a111111111111111011111011111011111110111111
020221121121201022012212001222111012122111221222211210011212211120011111111110011111110110111110111110111111110111110a111110111111110111111111111001010111111111
112211001112111122122221212122211002112022011211212221201011021120111110110011011111110111101111111110111111111100111a111111100111111011101111111111111111111111
121211112211110112201122012101011112022220200012020211020020021210110111101110011011110111111110111001111011011111111a111101001110011110011101100101011111111111
202222221120201020210222212112211112110112112012021222220222212201111101111110110001111111001011111110111111011111111a101011001101011100011111110111111111111111
221121201112121001221221122112101100122221120101221101112222121000110111111111010111101111101111110111111111010111101a111111110111111111001111111111101111111110
22221001121baabbbababbaabaabbbaaaaaaaabbabbbaaabbaaababaaabbbababbaaaaaa111011011110010111100111110111111111011110011a101001001111111101110111111111111111111111
01012022201a22112120021112221011101111010012221022211021020122221101011a111111111111011100111111011111111110101111111a110110111011110011111100111111111111001110
22121110122b11112220021122010111011121022212221110211112021122101011111a111111011111011110111010111110111111111111101a110011111111010111111111101111111111011101
22100221011b02112100022221201000011101101111110111111111110011101111011a111110110111011111111111111110001101100111111a011100110111110111010111111111111111011101
12100211121a22020021022111211201011101111111101111111010111101111101111a111110011001100111011101111011001111110111111a101111101111110110110111101111110011111111
01212112011a11201112021221212121010010111111111111111011111111011111011a011111111101111111111010111011001111101110011a010101111011110110111100111011110111101111
11111111011a11110110010111110111111001111111101010110010111111111111111a111111110011111111011111011110111101111110111a111111010111011101001011110101111000111101
01111101110a11011111001101101111111100011111111110111111111111001111101a011110011110111111110011011111111111010110111a110111101111111011111101111111111110010111
11111111111a11111111100111111111111111100111011111111111111111011111110a111101101110111010011110111111111101111101111a111111111101100111111111010111101111101111
01011011111a11101101111111101010111111101111111111111100101111011111110a111111101100111111011110001212121100212122022b212112211011110111111011111100111111101111
11111111100a11111011110011111101111111101100111111111111011110111111001a111101101011111111101111101020220221222121122a001210102011011011011111110111110111110111
11011110010a11111111110110011011111110111111111011101111111111111111001a101111111111110110011110011210222211202121201b112101002121111101011111011111110111111101
11110001111a11111110111111111111100111110111111101111111111111111011011a101011111110111000111111110011112201201212222a220221201021111010110111111111111111110111
01111111111a11110111111110110111011101101111111111100111011111110101110a110111111111111100111101101210102212122221101b112112122111110111101110011111111011011101
01011011110a11111111101011111110111111110111111010111011111111101011111a111111011111111111111111110200011121121210221a211220222221011111111111011101010111011110
11011101100a11011101111111111110111111111111011111101001011111001111111a101111110111101111111110101112202001200221201b212221202021110101111000111111101111101111
01111111110a10111111001011111111101111011110001110111011011011101111111a110111111111111101111111110102002222222210101a021111221111111111111111111111111110111110
11111011010a11101111111011111110101111010110110011110111111100111110111a111111111111111100101111112122112222221122112b211220210010111111111101101111111111100111
00111111100a10111111111111011011001101111111111011100111100111011110010a111101110110011111111111112121111221201222212a011221112111111011111011111001111111110111
11111111111a11111110110111100101110111110011111110111111111110111011002a111220111111212012112110212221110211122221121a212210202201111001101111111001011101111010
11001111010a11110111111111101111111101111111111111101011111110111110111a12221abbbaababbbbbaabbabababbaaabbaaaaaaaabaab111112102001010110111111111111111101111110
11111011111a00111101011100111111111111111011010111011111001111111101111b11201b1212101121222101111112222022112211112201111101122001001111111111010111111111111011
11000101111a11111100111101111011110111111111100111111111111111111111012b01002b2021022011011101101110211221112122202221210201112121111110111011001010110111001111
11111011111a11111101110110111111111111111111111111111111111110110101111a22201b1122120121102102122222122101210211201111112211201221001111111011111111111111111111
12210022102b02121110111010111101110100111101111011110101111110111111111b11212b0120202212202221112211022102222212211202122121121011101010111111101111011011010101
01220222012b02201111111111101111110101110110001111110001111110110100111b11102a2110222111221221112022222211020011222211011110222101111011111010111111111011111010
21202210112a01120011110001101111110111101011101100011011111111111011112a01221a1211211120210101121222211122211201200111011221111111101100111111111101011111111101
20111202020b02101111111110111111111110001011101111111111111101111111110b22122a2220212211121111122220211212121122221222222222112201101111111111111011100111100111
01101102211a12221101111111010110110110111111101101111110111110111111111b20222b1111212111211221121022211212111211202200212220122211111111111110111000101110110110
10222211221a22111111111111011010111111110111011111111111111110111110010a11221b1220102121202222022112211211001102111012022011201221011111011111101111010111111110
00022212002b11220011111101110111101110111110111111111011111111111111112b12121a1100210212210121020112110202021112200210112101111221111111111111010001111111101101
21120211222b21220101110111011110110111111111111111111111110111111111111a00122b1011011020112011111100012202000212122122222122121121111010111111110111010110111101
12010010122b02111111101111100101010111011110111111110101110101111111001b11011b1012122222121211202212211022111222120222112111001221110110111101011101111111110111
02201220121b12210111111011111101011111011111101011111111101111111101112a20222b0201111111111222222020221111222022022212102112122121001111111101111100111111111111
11212212121a11221111011001111111111111111110111111101111111111100101101b12022a2120101102122010111222201022112121222001121220211121111111101111111101011111010111
21211220201b22121011101111110111111010111011111111101111111110111111010a00112a0220102022221211011222111111022222121211212111221001111111111111111110111111101111
12221111100b12100011011001111111001111101110111111011111111111111011111a12112b1111201121222110111110102112120221000211011222122221010110010111111111001100111011
20122121121a21111111010101001111111101011110111111101111111001010111100b11112a2212211211112222211022220011021011012111222111121221010110001011111111101101110010
10022221200a12201111111111011111110110011101111100110101110010111111011b12122b0011002212221002212122221221121212110202111012102011111011011111111011111010111110
02112121222b21101111011110010111110110110011101011111111110111011011110b10121a0121201212211110211022111112010200212100000210121221111110111110111011101110111111
22222101122b22111101101111010111111111111110110111011110111100111111011a11221a0121002012100002202021011011111101111111101110111111010111111111011101101111111111