140 105
19 56
58 79
49 50
72 66
151 40
135 57
90 104
95 13
105 17
111110111111101101111100111111001111111110101111a111a11111111010111001111110011122022112222212122011012112b22120101011111111100101110101011111111111111011011111
111011011111111111101111111101111110111011111111a011a01101011111101011101111111112122121111202102022012212a21201011110111111101111100111111010111011111011111101
111111111110011110111111001111111111111110101101a111a11001111011001111111101001012022222210022220121021222a02222210121022111111101111110001101011100011101111110
111111111011011111111111111111111111101011011110a111a11001010111110011010011101022020002220202222221222020b22121121102001111111111111101111111111011110110110011
111010111111110111111111101111011111001111111111a011a11111111111011011110111101100022001201202012102120202a22221022022120111110111101101110111100100111111111111
101111011111111111110111100111111101110111101111a101a01111111011100111111111110112100102212222220221220222a11202111121100011011111110111101110010111111110111110
111111111011110111110011001111011001111110111101a111a11111111101111011101111100122111201120221102222120222b20221221200120111111111011101111111010111111111111101
111111111111100111111101011101110001111111111111a110a11111101011111101111111111110210122222222222020221202b22220012200111110011110111111111111111011110111101110
111111111101111101111111110101111011111111011011a111a11110110111101011101110011111102121012221212212122021b22210212221110111001011111110110011110001111101110111
111111111111111111011110111101001111101011110111a111a01111111011111110011111111101120222120121010220022221a22202122000100110101111111111111101110111111111010011
110111111101111111111011111111000100011101011111a111a11111111111111111111111011122011012112111220222122022b20020222110111001100111011111111111101111111011101111
111111011101011111111111111011111110111111001011a101a11010011110100011110111111112102112012222222122202102b22211012101212011110101111111110111010101101100111111
111011101001111011101110101111101111111011111111a101a11110111111011111111101111112210201112120200100120220a22021222221022101101111111111111011111111111110111111
111111111111111001100111100001011111011100111111a111a11111011111101111011111111111011021121220122002221112b22020212212211011011100010111101011111111101111111101
101111100100111111111011111111110010111110111101a100a11101011111111111111111111110012121112220201122222202b20210221022022100111111011111111110111111111111111110
101111111111001101110111111111111111110111111011a111a10110111111110111101111101120122112222222222122222121a12202122122022101111111101010111111111011110110101111
111111110111001110101101110110111111111101111111a101a11110111111111111111111111112222012022202220221011222b02222012222211111111111111111011110111111101111011111
101111111111111111101110110111111111110111011111a110a11110010100111010001011011122111111222002120021221222b22210102212112111111111111111111111100111111111010111
010111110111111110111101110111111111111111101111a111a10101111111111110111111011121122121202212122222220202b22012101012222110111111111101111111111111111111101100
111101110111101111111011111111111111101111111111a111a11001111001110001111100111122111202221222022020102212a22222011002112101111101101111111111101011111111101111
111111101111011011101111101111111101111011101100a111a11111101111110111111110111102122212202222122122002222b12211222012101111110101111111101101111111111111110111
111101011100001111111111111111111110110111111111a111a01111111011011111101111111102121201020222121212211221b22122012210002111111111101011101111111110011101010110
011111111111011010011111111111111111111110111111a111a11101100101111111111111111122110210220121121222002102b12121111112011111111111111011110110111111111111111110
111111011111110011111101111110110111111111111001a111a01010111111100011111101011121021222102222212122022110a22220221121112101101001101101110011100111101111000111
110110111011111110111101101101111111010011111111a101a01111011111111110111111111121220121020102202222221212b00021201122122000100110110111111110110111101111111111
111111111110001011111111111111111111111111111101a111a10111111100111111111011010111111202220102202120220201b22222210202212101111111111111212102121211101210001111
111111111111011101001111101111111110111101110111a111a11111101111101101111111101122010121122222121022110202b22120120111220101111101111111122101222200102112102112
110101111111011110101111110101111011001111001010a011a11111111110110111111111011121211122000220222120212020b22221221222211011111101010011221111121102022122222022
111011111111111011110110101111111110111111011111a000a11110011111010101111111011101121222122022222202221021b20221212222112111010011101111120011121112211110222121
111111110111111011111101111110111010110111011111a001a11111111101110001111011101110111111111101111212221101a10212211000211111111011101111211112112121022110210220
101110111111110111111111111101111111101011111101a011a10111111111111101111111101111011111111001221202001110a12210112211202111111111101111122201201012121212011001
101000011111111110111111100101111111111111111111a111a11111110111100101011111111111001111012210102011110101a21112222011112111110101011110221122121212000012021011
111101111101010111001011011111111011110011011101a100a11111111110110111011111010110101111110221112211100122a22211210222122110111011110111211012111110110121012112
101001111100111111101011111111111111110111011111a111a11111111101101010111111101110110111111111010101111111a11111101011111011010101010111211122202002202221021112
111111111111011010111000111110111011111010111111a111a01110111101101011111111111111111111111101011111111111a01111111111111110110111110110211202212121211122202211
110110011101110111111101111111110102102111000201b111b02002010211211111111111110111111111101111110001111010a11011111011110011111110111111121101010122221111222211
111110010111111111011111111110111111112100102122b111a11210012222210111011111111111110111101111111001111111a11111010100011110101110111111210022111221201110211021
111100111110111100111111101111011122120111210211b022b12101010122111111111111110101111110111111101111111101a11111111011111010011011111111210111022121210012211012
111111111111001111101101110111111111221112221110a212a21212021202211111111011011011101111101111111111110111a01101111111111111111111111111020120112211022221022210
110111111111001011001100111101111102121112022201a100a21122021211111111111110111110011111111110111111101111a10101111101111110111111111111210020121222112211012100
111110111011011111101110111100011111020110012222b202b02211022121210110111111111100111111011101110111111111a10011011111111110101111101011111211121222102121121222
111101111011110111110111111010110122012202122002a121a01112102212101111001111111100111100011100101100111001a11110101111011010010001111111101122022221111110112212
111111011111111100111111101111111112212221210122b201a21211221112011111111110111101111111011111111111111011a01100111111110221110221201012212102112121220110010111
111111110111111111101111101111111110220011211111b201b01111012121111111111111011111111101111111011110110111a11111001111111211101112211121221220222201002112202211
111111011111111111111111111101111112011121102212a121a12111212122200111111101010111111101111111111110101111a11101111101101211112211221021212abbbabbbbabbbbbbbbbba
111111110011111010111110101100011122201121220211a112a02121010220201110111111111101111101010111111111111111a01011111110101212001021221222220b1220022222112020101b
111101111111111101011110111111110101002200210222a120b21200111201011111111010111111111111111110011011111101a11111111111002222222102012102211b2202222222220111212a
111010110111111011111101010111111122221020021120b221a12122212002111110010111101011101111111111011111111111a11111111011000210212222012110012a2222211212200202110a
111111111010011111101101111101101110222112022211a220b01211202210100111110101101111010101101011110110110111a11111111101112001212111102121012a1021111202121122212a
111110101101111111110011110111001121111012211110b101a10011122221211101111100011111011111111111101011101111a11111111101012202111022112221211a1212222221202100102b
011111011011111101111111111111011120000011120202b222b20200212121111011111101110111111111111011111111101111a01111111010111211022202202022002b0202022122211112111a
011110101111111011101111111111111121211122011001b210a01220212210121122000212002222201112111100111111111111a10011111111012112212212201120122a0222222120221120101a
111111111111111110011110101101111111121100221112a011a11202202022211111111001202200102112001101101111111111a10011111111102222212221121121221b2202211022201211121b
101111111111111111011111111111110110211222012110a211a01112022222220220222212211121222112111011100111110111a01111001111110120221211002222021b2222222011211222212b
101111110011111111111101111100111022121110021022a111a10110201222201221212111220020210122111101101010111111a11111111111101111001111022201211b2202220211221211121a
101111011011101111111111111100110121101221102100b122a02112111222202021211112021202211122011111111111111001a11011110111112022112202211222220b0222212022221211221a
111111111101100001011111111111111021111121212221b022a21212222220221212222001222211012111011110111111110111a01011111010011002001210212122200b2111112222111110111a
111001111110110111111111111111111111112122102201a101b20002222122210202001121222112212212011110110001101100a01110101111111212122012002201001a2112101211201101111a
111101111010111110111111110011111012112221221212b112b21212222202111112221222211122111022011111111110110011a10110010111101201021211021121112a2220022121211101110a
111101111101101011111111111101000101112110210110a121b11112102112211101010012122122221202111111110111111110a11010110111112222111212111112002b2212121102111111101a
011001101111111101111111101111101121211111112111b020bbaabaabbbbbaabbaaabb200122210222221111110111111001111a11101011111111111210212122120010a1021201221111111101a
111110100111111010110111110111111122121111011102b11111112212122222111120a022221211122111111111111111100111a00111111111111101012112222121021a2220211202211110111a
111101110111111111111111011101101101220220212020b20121200212011221222210a012222101122222111111111010111001a11110111100111022122100112102111a1122112222111111111a
101011100111011111111101111110111110101111210102b22122001202222220220002a221111101221112111111111111100011a11011101111110222201022222122222b1002102121000110111a
110110010110101011111011111110111120122212212212b22121221212001221212220b201110012002221111111111110111111a111010111100aabbbabbabbbaabbbabba2211122220111010110a
011101111111111111111100011011001012001111001022b02020121220220222222020a221112200121121110101011101111111a111111111010a0212000112122202100211012201201111011010
101101111111110111101111101111110011111110021002b12021211221202222021202b121012012220112111011010111001111a110110111110a2120210211221111012122221221112111110111
111010111110101101011100111101111111101111122210a10102221022222202122220a102111221121101101101111110111111a011011011101a0112221100022012122111111202222101111110
101111111110011111111011101111111101111011112121b02212012210010222222121b211110011111121101101111111011110a110010110111a0102222121221212111111122211201101111001
111101001110011111111111111110011110101101112211b12111222022022122122010b222222022101121111011011110111110a111111111110a2012010010110121120012221101101111101111
111101111111001110111111011011111111100111102020b11121120222022221022222b202220110221122111111110111111111a111111011111a1112121111102222102222122022112011110111
010011011011111111111101101111011110100110122211a11121222220022022122112b001201111112201111111110111101101a111111111111a0211122210120221021121111121010111011111
111111011111110111011100110111111011111110110222b21222220221120222121222a211011101122001011111111101111011a111011110111a2121201212122121221112221212221001110111
110101111111101101110111011011111101001101121121a20221120022220121222222b201212122010202111101101111111100a111101111111a1101111001100110111111111111111101111111
111000001111111111001110110101101111011011112001b22222220022202211222122b122012101022212101101010111111010a101111111111a1111011111011111011101111110110111111001
111011111111011011110111111111110111111110010111a22122110222111220221002b212012202020222111111101111111101a101111110111a1111001111110011110011011101010011110110
011010111011001111011101111011011011101111122112a21100011222210202011221a021120121222221101111111101111111a111110111011a1111001111011111111111111111000111111111
011111011111111000110111110001011111110111021211a11120010222022200022121b211020002122221101111111101101011a111111111111a1101011110110101111010101111111011111111
110010110111101111111100111111111111111110112222a21221211022022122212222b212111120101101011111001111111111a100011101111a1111101111000111100111011111111111111111
100110001100101111111110111111101101110111110212a02211122221220212222222b021121210121222111111111111111001a111111111111a1111011111111101001111111101111011101111
110110110100101111111111110111011111001111121122b12202210202122222202222b202202202020121111111111111111111a101111110001a1111011101000110111111101001001111111001
111111111110101111101010011101111111110111121110a21120021221220122221222a100110120001121011100111111111111a111001111111a1110110111111100111111111100011111101110
111110111101111011111011111110111111101110112111a11112122010112212122112b201000101110111110111010111011111a110111011111a1001101111011111111111101011101010111111
001101111111111111111111111010111111111111102211b11121002021212201220012b111111010001111011011111111100111a111111011101a1111111111011011111111101101111111111101
111011111111010111101111101111110111010111111121a11220110222011211211101a011001111011101111110111111101111a111101010111aaaaaaaaaaaaaaaaaaaaaaaaaaaaaaaaaaaaaaaaa
101101111110101111000101111110111111101111122210a21111101220111122021012b111111111110110110011111011111111a11111011100001111110001101111111111011111111101111111
111110111111111011011111011111111111110110120122b01222211011001201111120a110111111111111101111111101111100a10001111111011111111011111111111110111111011100011111
111111111111111011110110110111111111011110111022b12021122112002222122222a011111111111101110110111111111001a01011101111100011011110111111001111101111111111111111
111101001100110111111111101111111111111111122121b10222222121002121222122a200011111111111001101111011111111a10111111101111111111011111111111101101111111111010111
001001001011111111001111110111111111111101112012b22102011110021121121102b112201221220121202111202202221011a11111110011011101111011111111111111111111110011011111
111111011011111010111011111101111111110111111212b21221222021121101001211b112021010222100101122112222020222a00101111111111111110111011101111111111101111110111011
011011111110100111101101100110111111111011102212b21010122111022200112212b011221201202112002211220012112110a11001011111111101011111111111101111011111011111111100
111101111101111011111110110111111110111110112120a22122201021200122121121a210112212010022011012012121211121a11110111110111110011111111011111111111111101011111111
101101111110111110011010111111100011111010011122b22110202121022111101002b111101022222112020101212110011211a11101111111011111111111111011011110111111011111101111
111111110110111110111111111110111011111111120211a12200221012220120010001b211021112121100212221212111222011a11111111011001111111110011110110111111111111001111111
011110101101000111111011011010111111011001111101a11110111111011110111101a110201201011221112222222212202212a11010111111001101111111110111111111111111111111111011
110111111111111100111110111111111110110011110011a11101111110110111111111a012122022212020221012022022121011a10111111111100011001110101111011110110111001111011111
111111101111111101101111110100011010111101111111a10111111111111110011111a001212110222222110221011121210111a11111111111011011101111100001101110101111111101101101
111101101111011101101111001101111111111101111111a11111111110011111111101a011021110121112110222121202001100a10111011111011111110110111111111101111011101111111011
110111010111111111110111111101111111111111101111a10110110111110111101111a111112022022201122210021100202122a10101111011111111111101111110011111110111011111111111
111111101111111011011111111011110011111111111111a11110010111111110101111a101201201111122211101110120111221a01101111101110111110011111111111111111110101100111111
111111011111111111011110111111101111111111101111a01111111111101101111101a012222121120221202120121201112120a10110110111111111110111110111111111011011111111111111
111110111111110100111111101001111111111110110001a10111111101000011111011a010112001121222221111012220021122a10011111001111010111110111011111011101111110111111001
101111101111111111001111111011110100111111011111a11011011111011011011111a102212110222221120200201211102101a11011111110001111111111111111111011111111110111111111
111111111111111111111100010000111111101110111001a10111011011101111010111a112121202222211222222201012212221a00111111111101111110111111111111011101110111111111010
111010111111111101101101011001110110110111111111a11111100110111110110111a012212202211212222012110022111222a11011010101101110111110110111111110111111011101111110
110111111111111111100011111111111111111111011101a11111001011011111101111a111111211201210201001011211221112a00111111110000101111101011111111111100011110101011111
011111111111001111110111111101111111111111110111a11111111111010111101101a112121102220101221101212012121211a11111111111011111011011111010111110111111110011111111
111101111111011111111111110111111101101111101011a01111011111111011110111a112022122102112200111221121102122a01111111011111111000111111111110111111111101111101111
111111101111011111011111100111111111111111111111a11111010111111111001111a111212221022212121221222122211121a11111101111111110101111111011111111111011111011011110
101101111110011111111011101111111110111111111111a01101110111011010111010a102121121111121221020212022212212a11111111101110101110111101111111111111101110111111101
111111111111011010011111111101111011111110011101a01111101110111111111111a111111221211221112222101001222122a11010111111111110110110111111111111111100111111110111
111111111101110110111111111011111011111101100001a01011111110111011111111a111221111121012122202110122222111a11111111101100111111111111110110100111101111011101111
111111101101101101101111111111110001111111001111a11101111111111111110011a112122200222021222122011221012222a11110101111101111111111111111111011111111111111110111
010111101110111101111011101111001101011110111110a11110011111000111111111a110121111221120222202211002000122a11110011111011111111111111111110111110011110111111111
111111110111111111001111101100100100111111111111a10111111111011011111010a102201222222211110211212121211212a11011110111110011111011011101101011111100111010001111
111111111111111111111111111111101111011001110011a00010111111010111111111a111121121210021021201211111210121a11111011101011111001011010111010111110110111111100111
010111111111101111110110110111111101111011111110a10111101111110111111110a101110122212211112022111021102212a11011101111001110010111111101111011111101111100111111
101111101011111111011011011111111101111110111111a11101101111111111011111a012201221221220212212222212222221a10110011110111111111111111110111111111101111100010111
010011110101101011111111111110111111011111111001a11010111111110111110011a110011010012112111021202121021112a11111001111111111001111111111111111111011111100100111