26 18
102 108
86 116
104 46
63 50
59 117
139 97
118 28
76 3
12 40
111111111110111011100111111111011111101001110101111111a111101121121220011111112011211101110111111110111111111110111111111111111111011111111011111011111111101101
111111111010111111111110111111101101111111111110011101a110111221112122010122011111220220201011101011110001110101011111100111001111011111111111111010111111111111
111111011111011010011110111111110111111011001111111111a010111110022102222121220211020221120011001101111111111101111111111101111111111010110110111101111011111110
111100101011110111110111101101111111110111111111011111a110111022112122120101100011111111210111111111110011101111101111110101111111101111111111011110111101111011
111111001011111110111011111111000111011111111111100011a011101122010222201120210112221222122011111111111100101011101110101111111101101001111111111011110111111110
111111111010111111110111111111111011111110111111101101a110111110021210212012122102121112212011101111101111101101101111110111111101011111111101011111111111010110
000101111111111111011100111011101111001111111111111011a110111122110221220200221111021122211100110101111111111110111011111111111111101110101011110111111011111111
111111110111011110111101110111111111111111111111111111a111100221221122112012212111102112121001111111011111111100011101111111111011011111111111110010101011111110
111111101110111111111110111110110011111010011000011110a011111201212221102120222220220120221211111001111111001111111101111111101111111111111111111111111010111111
111101111111110111111101111111011111010010110111111111a111111220121121011110112110210211211110011111111111100111111111110111111101111111111110111111111111111111
111111101111111101101111001011110101111111110111011110a110110102111021012202021120110012220011111001111101111011111011011111110111110111111111111111100111111111
111011111011111001111111101110011111111101110111110111a000101111221102110010122212222222121101111101011010101001111111101111110110110110101111111110101111010111
010011111111111111111011011110101010111111011111101111a111011122210220110212212200120202021111111111110111111111110111111011111110101111101101111111111110111110
111111110011110011111101111101011111111111111110100011a111101112022121201221001112121202101210111101010002122212121011102012210202212111110101111110111111111111
001111111111111011111011111111110101111111110011111111a111111112211101111011120211121111121010111111001212222200002222121121110020122111111111111111111101111111
111110111000111111111111010101111101111110110011001101a101111012010111212211122011122221122211011111111111221011012012222201201221202111110011111011011111101011
101111111111111111011110111111110111111111111011111111a111011011112022100212200122211021012101111111111012020110022012121220022012111111111100111111111111110101
110111111111111011111111000101110110111111111011111101a111110111221001122211121211120221121111111100111121112121022110212211112212210201110100111111111111111111
111101111111111111010010111101111111111011011110111111a111111212212122012201212122112210221211101101101222122022212012201012012012011010111101110111110101101110
011010000111101101111100111011011111111101011110100101a10101101111111101111111111011111011111aaaaaaaaaabbbabaaaababaabbabbbaabbaabbabaaaaaaaaaaaaaaaaaaaaa111111
011111110101011101110111111110110100001111110110011111a11011111111101011111101111011011110011a11111111021211021211102121200021211000100111101101111011011a111111
111101110111111111110111111101011111011011111111100111a11111111111111100111110101110111010011a11111111121211110211111212110022010021021011111100111011011a110111
aaaaaaaaaaaaaaaaaaaaaaaaaaaaaaaaaaaaaaaaa1111111011111a00011111111111111111111010111111111111a11111110120020210200012120002211212011211111100111101101011a111111
1111111101111011111110001111111100101011a0111010101011a01011011111111011110011110110011111111a11011111012210122011011221121122121221110111111010111011111a011111
1110011111111111110111111111101111111101a1111101111111a10111111011111111111111111111111101010a11010111102201212021200020202111012102120011100101011110111a110111
2221000210221110112002020121110110111111a0011001111111a11111111111110011111111011111011111111a11010101021212110201021020021201212111021111100111110101110a111111
2121221111121122111101221121101011111100a1110111111111a10101011111111010111111111111011111101a11111111002000220121221110011011022020211110111101011110011a111110
2211122221211121200220110010111111011111a1111011111111a01111101011011101111111001110111111111a10111101012220221210020201211212211202011101111110100101111a111111
2210102012002211201212122121010100110011a1010111111111a11101100111001011111110111111111111111a11111111101220021121221222120221011101121101110111111111111a010111
2221112022221212111111112211111111011111a0011111111110a11101110101101111110011111111111111101a10011111101020221020212222021112021221001111101110101111111a110100
1221122012112211112001022220111110011110a1110111101111a01111111111111111011111111101111001100a11111111011101112121122122222102001220121111011001101111111a111001
1112222221021211020011121101101101110111a1100111111110a11010110111111011111011111011011110221a11111121222222112222021012021210220012221110100111111111111a111101
2212001101011210120211120101111111111101a1011101110111a11111101111111111111011010110111111221a12210200120002222221212020111212211021201111101010011111111a110111
0021220122220222021222021002110101111111a1110111011111a01011101011111011111111111101101112111a21212222202221222212201112121221211121210111011111111001101a101111
1012211221120221102112121111111111001111a0101111101111a01111110010101010111011111111111111202b10110000222101122202220100011222221101121010110111011111110a111111
2111110122100112121211202221111111111111a1110111000112a21201020121022021211222111111111112201a02200222002222022202211022111121021202221101101111111011101a111111
2202021110212002112112111222110011111111a0111111111102b22122122212122221122010211111111110221b22112120122221220210121222101122211212221110101111011111101a100011
2012022222210111012111011111111111111111a1001110210220b20221011100012121222211200111101011021b22122112112120222211202022012222112111200111001111111111111a001111
2201211000011011222111112220111111110111a1111110122122b12021210211112021210201111111111110010b02122121202212121002222102011120121211211101111111111011111a111010
2121222202121222112221210121111101100011a0111111021222b20222222221001102221221111110111010112a11112111112000221120222222002222222101201011001111111111011aaaaaaa
0210210211122111102200021211011111111011a1100001212211b01010100202100121212001211011111111101a202210012222210211012222222121220222012110111111111111111111111110
2012112012221220112212101222110101111111a1101111110120a12111110211112210221222011011111112010b201112212222222122202102121202121211121111110111110111111011110111
babbbabbbbbbbabbabbbaaababbbaaaaaaaaaaaaa1111111212221a12212012202211212022220211111011111112b022122211122212002222221211120221201122211111111111110011010111111
122221011111121112011021211201101011011111101111210211b22222220211012101112001111101101110210a112212010221002222202221222001221202122111011100011110111011111111
202212111222201220021211211010001001110111111111112221b22001111201100220211211211011110111121b221112001212101211122210211011111101110101101111010111111100011011
221102201201110112210221010111111111111111111111210122a10010112220111122102020011011111111220b0111110212200111122022122aaaaaaaaaaaaaaaaaaaaaaaaaaaaaaaaaaaaaaaaa
011121121022222222202211212211111110111111111111111111a12221010212111111202121210111111111010b0201221211110222100200000b111110110111110111111111111111110011111a
010212212112122122201222212210111111111111011111212021b02102112102111021002212110111011111211b1212110202121201112210200a001111111101101011110101110111111101111a
221221100112211120222211212011110101111010101111122001a02102212121002021221202211111011112220b2112110111212222221001221a011111111111101111111111110111101111111a
001110121211012210122020111210101111111111111001122122a11101122201000212111000111111111112022b2102201211112120221201012a111111111101111111111111001111111111111a
112122101210222101220022022011101101010011111111212221a22212110212110112222212111110111100122b1212122202202012202011122a100111100011111111110111111111111100111a
122122202211212122221221212210101111111110111111022112b02220122110021120201212211111111012110a0122102112110021212122112b111111111111110010111111111010011110010a
111211010011211102102121012111000110101111101011101222b22121211221110201112112101111111112212b0222221101120202021220002a011111111101111111111011001111101101111a
222101220221212212211212121211111111101011111101200202b10012112211111111221221201001111112210b2022220110011012101222110b101111111111111111111101111011111111111a
222201221222210221121122212211100111111111111011010221a11222221221111222221120211011101012012a1202110102202021100100112a011101111101111111111010111101101111111a
121220120201121112221222222211110110011101111100110121a02212222121012022220222111111110002212b1210021211110111112220101a111101111111011010011101111111011110110a
011010111111111111111101111111011111111111111111210222b22222222202222012122212011111011111202b0210121201221010121011111a111111011111101001111111111011110111111a
101101111111111110101111111011110101111101011001011102a12220221222211112112122111111101112221a0220222120112102001000200b111111111110111111111111011111110111111a
111111011111111111110110110011111011111111111101012212a10020200210122102210212111111110111002a1101212222100111222002111a111111110101111101111111011100111100110a
011111110111011011111111111101011111111011001111211001b12002022211010222211211111111110011220b2221220201201212220211201b111111111100111101110111110011111110111a
111100110111111111101111111111110111001111011111112122ababaabbabbabaabbbbbb212210111110111222b1121122112112111010101222b011111111011101010111100011111111111111a
11111011111011100011101111101111101111111111110101202212212222121220202010b211001111111112121a2112120212111122112111121b011111111111111101111100111101011110111a
11111011110110111111110111111111101111111110111100120221201012221201112111a222011111111111101a1111111100011010001111110a111101111111010101111111111101001011111a
11110111101111111111010100111101111001111111110012001122120110011210120110a221101011111111111a1111011101011101110111111a111111111101111101011101110111110111111a
11111111111110010111111011111111110111101100111100120002012001022111221122b202210111111110111a1111011111011101111111111a101110111111011100110101100111101001111a
11111111110100111110111111111110111101011100110112202202002111212222121222a110111111111111111a1111101111110101101111111a111110111101101101100111011111100111111a
11101111110011111111111011110111011111111110011101101110111110110011111111a111110111111110111a1111111111111111010101111a1111111111101111101111111101100110111111
11011110011000001111111010011111101111111110101111110111101111111110111110a100101111011111011a1111111100111111111101111a1110110110101111111111111111111110101111
11111111111011110111101111100101111011111110111011011110100110111111101110a110111111111101101a1111111111111101111101111a1110110111111111111011111111011001011101
11111101101111111101111101111101011111111111111010110110011111111011101111a110111010011101011a1111111101100010101101111a0110111111111100111111111110111111011011
11111110011110111101110111111111101111110110111111111111011011111111110111a011111010111100111a1011111111001110011111111a0111011101111111111110111111110111101110
11111111111111111111101111011011111001111111111101111111110110110101111111a111111110011111111a1111011111111010111111111a1110111101010110111111111011110011111011
10101111111101111111111111111111101110111011101101011111110011111011111111a110111111111011110a1001110111111101111111111a1111111011111100011111011111101111110111
11101011111111111110101111111111111111111011111001111111101111011111101111a111111111111111100a1111111001111101011110111a1101111110111110111011111101111011111111
10110110111111011111101111011010111111111111111111011111111111111111101011a111111110111010101a1100011011101111101111111a0011101011110111111110111110111111111101
11111101111101011110111001001111111111010111001101111011110111111111111111a111111111011101111a1111111101110011101111111a1101011101101111110111111111111101011101
11111011111111001110111111110110010111011111011111001111111111111100111101a101111111010110111a1110110001111100100111111a0111111111111110101111110110111111111000
10111001111111111110101010101111111111110101111111111101111111101111011010a101110010111101111a1111111011110111111111011a0110111101111010110001010111110101111010
10111111011011101110111111111100111111111111111111111011011111011111011111a111110111011111011a0111111111111111100111101a1111111010111101111011111111010100111111
10111001111110111111011111110111111001011011111111111111101111011111001111a011111111111111111a1111111101111011100101111a0111111111111111010000111110110111111111
00110111111111111111111111111111101111111011111100101010101111111011110111a110111011101001111a1111101111101111011111001a1111011110111011101110011111101111101010
11010111010111111110110111111111011111111111111111111110101111111111101111a101011111111111111a1101111111111111110101110a1111100111101110111011001011010111111110
10111111111011111111101011110111111111001001111111111111111111111111111111a111111101111010111a1111001011111011001111111a1100010222111111212211211222221100001010
01110010001011111110111001110111101101111010111101111101111001111110110011a101011111110111111a0010111010010111101101110a1011111202211110210221212211211211111011
11110010111111111100111111111111111011101001111111111011101111001011101111a111111011111111100a1101111011111111101101101a1111122222001102111211221010210102211011
11111011011111101101010111111110011110101101110111101101111110111111101111a101101010101111111a1111111111110111101111111a0111002122111211120112200102221212211111
11101110011011110111001011101111011111111110111111111111011111110111111111a110111011111111101a1010111011100010101111111a1010111102222221200111102111021212111111
11111110111111011111110111111110111011111111111111011111111111111011110111a100110011111111111a0110011111111011101111101a1111110112122112122100121111212112211111
11111111011101111111111111111111110111111111101111001111011100111111111111a101110100111011111a1111101011111011111111110a1101221121012211011212212211211122211101
01011101110011110011111101111010110111110101111110101011111111110011111111a101111111111110001a1111111111111111011101100a1011212121121102011002011221201202111111
11111101111101111111111111111111110111111111111100000101101011111101111111a111111111101111111a1111111011110111011011011a1101122020122101012211221012011102101011
11110111011111111110111010111111110101111101101011100111110111101111111110a110111111011111111a1111111111111011110111011a0111012212222212012222021021011112101101
11101001111111111011011111111111010110101110011001111111111111111111110111a111101100110111011a1111001101111111101011110a1101212022122022201102112112012102211111
01011110011101101101111111110010111111111111010101111110110111110111111101a111111110111001111a1010111111110010111111011a1101211122220211010120211221102120101101
01111111111111011111111111001011111101111011111111110111111111011101110110a011111111111111111a0110111111111110101111011a1111020212212221211122202012111120201111
11110111110111111111010111111111100111111011111101011110111101111111111111a101111111111011111a1110101111111101011111101a1111100021121101112020211202201121211111
10110111011011111111111111011011110110111110001111111101111111101111111110a111111111111011111a1101100111011111110111011a1111122221212121201110021102200212111101
01111101111011001111111101111111111110111111111110111111111110110111111010a111111111011111111a1101111111111101101111110a1111121101102012101022122211111121010111
11111111110011111001110101011101111111111111110011111101101111011100111111a011111111111011111a1111100101110101111111110a1111101211210112200211010202210011101011
11011111110101110101011110111110110111001011111111111111101001100101111111a111001011111101111a1010111011110011101111011a0111201111211201121111122211101221210111
10110111111111111111111110111111101110111111011111011111111111110111111111a111110111110110110a1111101110010011011111111a1111211221012112220020210210122112111111
11011111111100111101101111110110111111011111111111010110000111011111111101a202221122102211222b1010001211111111001111111a1111210112211020122111212111210012211000
10111111111011111111111101001111011111011110110022222200210120110210112222a012110221112121021a1101121011011111010111110a1111222102102201122110210201010120011101
10111111011111111111111110111111011101101011222022210020112121111021210202b022022222112201222b1112111211101000111111000a1111012021111221202112121012212122111101
11101111111101101110111111111011111011100111221121211011112202001211211112b222022021221111121a1122112201101111111111111a1100011011112120210221011200120110011111
11111111111110101111110101111111100111111111222222021222120220102100111022a220120201212220112a2000211211101110001111111a1001121202122201222221201212112220210101
11011111111001001111011111100101111110101111112122212112212022012202121002b221112110202120021a0200111111111111011011101a1111101011111202022101121120011121200101
10111111011111001101011011111011011011111111111112110122201120001100121112a102120001211212212b2022221211111110111111111a1111102221021102112222122021212211011111
10111101111000111111111101011100111010111111221221022212202110212220112202b222212210001112122a1012112111011001111011111a0111111010112212111220111102120212211110
11111111011110111111101001011111111111111111221222221121121012211212101222b121112101112111121a2122111211010111111011110a1111012222112101111202111111111121111111
01111111111111110110111111111011101111111011112221012101011211122211020222b102111111201021120a1201222011110111011111111a1001221212111222221120212001122021111000
00111011111111011111111111111111101010101111212122222220221220212122021211a020221200012212210b0010211111011110001101111a1111100021122101221201120001112202011101
10111111111111111110111101101111101110101101221111202001111222022222112111b210221122121010202b2221021210011101101111111a0011102102121210202202212222210122210111
10111111110111011111101111111110100110110110121210110012012211120221002220b112122100212111221b1221122210111111110111111a1111111101000111111100110110011111110100
00111111011010110111111111111111111111111111012111202211200011122120211210a022112002212020112a2211100111111111111111111a0111111111111011111011111111111110011111
11111011111111111101111111111111111100111011212221022101212210111121220222b100111122021212220b1112200111111111111011011a1101011011111111111101111111111010110111
11001111111111010000111101111111011111111111210011221201121212222022110222b012220211121122121b1210222210111111100111011a0011011100111111101101011111111111111011
11111111011011101011010101111111111011101110210222011121002220222102121122a210110122222121111a0011212211110111111011111a1111101111011101111101111111111110111111
11111110111011111111111111111111111111011111121221121201002211111220111200b121212201101011220b2221212111111111111011001a1111111110111111010111101111111011110111
11111111111111101111011111111111101111101101121021211202220121122211111022b210201211122212102a2011211211100110110110110a1111101111110010111011111110111011111111