10 71
145 112
78 51
71 38
4 36
140 44
72 11
112 99
82 9
12 73
11111111111111110111110110111111a111111101101111010011110122212200202222b221b02222112202122211110010110111111101011111110111111101101101111111111101001111111111
11110101111111111110011111111111a111010111111101111101011012222100201220b121b20010012212102121222111110001110111111111010111011111110111111111101011111100111111
11101111111011101011100111100111a110101101011111111111011100220021010212b210b22220122210211202120211111110111111110111110011111111111111110111000111111011111111
00111110101011111110011011101101a111011111001111111111111022011122122222b122b22102110112221212101211110101111101111111111000111101011111111111111001111111111110
11111110001101111111101111111010a111110111110111110011111021102022122220b001b22222202212222121222211101111111111111011110111111111010111101111111101110111111111
11011110111101111111111111110101a010110101110111111111111221121212112200b021b20121221222210012222111111100011111010111111110011111110110100111111111101001111111
01110111111101101111111011111111a111111111111111111111111110022202122122b222b22200010021121111121211111111111111111011111110011111111111111111111111111101111111
01111111101011011111101111110111a101110101011111111001110222112021210210b222b20102212120012112101011111011111000010111011101111111111111111001110111111111111001
11110111110111110111100111110111a110101111100100101001111001111102122020a121b22012220221122021010211011111111111111101011000110111111001111011111111011001101010
01110111110001101000011111101111a111111110111111111111110210121101022222b221b22221222022221111011111110111111101001111111111111111111111111111111111101110111111
11111011011111110111111110111110a111101111111101110111111201222111202022a120b12012222212100221122211111100111110011011111011111111011111111111111010111111010101
10111101111011011101111011111101a101101011111111101010011110212221222121b202b11220020012211120222111111011110111111111110101101001111101111111111111111110101111
11100101111111110111111111110001a011111111111111111011111111121112022221b212a22102122212121022211201111111111111101110111101111111111111110111001111111111101111
11111111111111111010110111001111a011111110111011111011111121012212221202b122a22220220020010111111211111111110111010111111110111111111111101111111001111111111111
01010101111101111101011011110111a111110111111111111011111121101211000201b202b22221022022000100022101111001101011011111111111111111111111010111011111111111011111
01101110011111111011011001111111a101111111001111001001101112212021101222b001b01222122010020012220211111110111111111111111000101100011111111111110111111010011111
11101011110011000111101111111111a111111101101101011110111122011122222202a222b22022210101212211021011111011110110011111111111011111101101110101101101110111111100
11011111111011110010111110111110a111111101101111111101111102001211210202a222b22122222101222002220011110101110111111111111011111111101110011011101101100111011111
11011110010111111101111011001100a110111110110101100011111212222221202222b022b10212221212201210011211011101111111101110010111111011111100111011101111111101111111
11111111110111011111111110111111a111011111111111111101111122121021201222b122b12212220022122112211210aaaaaaaaaaaaaaaaaaaaaaaaaaaaaaaaaaaaaaaaaaaaaaaaaaaaaaaaaaaa
01111011110101111111111111011010a111101110111111111111111121212112102102b122b21022101222122220110110a11111011111111101111111111110101101110011110101101011111111
11211211111000112122111110101011a100111101111110101110100221221102212222a222b00221221222022220101101a11111111001011111111110111111111101110111111011111111111110
11211011011121202012011011001111a111111101110111101111111111101021001222b222b20022110222201021111211a01100111110111001011111011111011111110111111111111111011001
11112221122100211102111101111010a111111110011111001111102222220122122222b122b20221212121221111101001a10111100011011111011111111111111101101100111111011011011011
10112201112210012222101011111110a011011111111110101101110221020002102022a222b22222222202022000112011a11110111101111110111111111111111100101011111001111011111110
21210112221112121100111110111111a011110110111111111111012111122201120021a222b22212211222101101101011a11111010111111111111111101111111111110101101111111111011110
20022201222102121211111111111011a011111110111111110011110222022222220220b120a20221222222111111111111a11111111100110111111111111111111111111111111111111111111011
22221102210120200212111111011111a111111111111111101111111102021110120122a011a22101111121111011111111a11000100111101111111110111011111111111111111100001111101110
20121011101020112201011101111111a010110011111111111111011111221020112111b022a12211212111011111111110a01111111111111111100101111011111111111110110101001101100110
01210211101212221011110111111101a111111101111111000111111121112111110210b222b11101020100101110011110a10011111111111111111111120101121012221200211100222200211111
22212000122121212222111111110111a111111111011011111100112112101211222202a112b21110112021111111111011a11111111110111111111110111221111221101101101202110222021100
11220222012122211121111111111111a111111111111111000111112111021211101101b212a10101212220110110011111a11011111010111111111111102212020212222120112112201111121111
21222122202011122221101110111101a111111111001101111001110212002121211121a111a21120121011111111011011a01101101011110111110101122101011202120222222211112112121111
22111022201221121222011101011101a101111101111111101110111021211211200212a212a21221221021011101010111a11111010111111111111111102202211212211111222012222110111110
20222211222211022012111111101111a111111110111111011110112002102212212011a110a00112012201111011111111a11101101111101111111111122021101102011122210111122112101101
02102120100120102212110011111111a111010110111111101111111200210222220122b102a22121120221110111011111a11111110101011011011001112111110221111222222012102022111101
12220122201211211222100011111110a111111111111111111111111212211220201122b222b21112122022222221110011a10111001111010111101111021122222220201102121202011111101010
11202011201021210120101110111111a101010001110111110011112220121222022201b102b21122220212110121100011a01101111111011110100111101012100002220112221001111210211111
12212222222221001101111111001111a010111011011111111111112211211220222122a220b22012222012012211011111a00101111111110010111111012122011202220212011012112121001111
20221122122022020110110111001101a111110011111111111101112122202201010021a212b00222222120122222111111a11111011011111111000011112202222221201102212201122122121111
11222111122021112210110111110111aaaaaaaaaaaaaaaaaaaaaaaaaabbaabbbbbbababa201b10012122002210112111111a11111101111111111111001122022200122122122122100001011111111
1222211102121221022210111111111111111111111101111011111112110222200021200122b22012200112011121101111a10101101011100111111011121221102211220111222210222002021111
2200121110212111112111100101111101111111111011111111111112102202102222021221b22222120222102121111100a11011111110101110111111022220121112120011011211102101001101
1222201011121100212111110011110111111110101101110010101102012120122112222122a20220122100100010111111a10111111110111110001111110202122211201212121222102012011101
1110220200021221210111111111111100111011111001011111110110111102210220022122b21102222210220102001011a10110111111111111111111102212122012110200121220122122101101
0110210100110121112011111111101110111111111111110111111010101222022122222202b20120122122122121011111a11111110111111001111011111212112200001122222112002220211111
2212011211122111222211111111111101111111111111110101011012111221221202222122b22122122122210201110001a01101111111111010111101012122100111210020212101112101120001
1111220211212212021211111101111111011110111111101001111111111222100211220022a22220220122122120011100a11111011101101111111111110122112121221121201211212221121110
2022120202121201202111001011110111001111101010111111110122212212222002221200a22020220122121112111111a11111111011111111111110121121021111212021120220111111210111
1220211111100102121211111011101100011111111111010101111121102010021200122022a11222212221201101111101a10111110111110101111111102121220222112211110212122122110111
0212221201221211020111101010111111111111111110111111111122110222222212102021a12222212122101102011100a10100011011011010110111001100112110222212121112211022211111
1211112222222212211111101111011101111111101101111011101122220011212220002212a22222211212221202011001a01111011101011111101111112220122120122212122221101121111111
1111111110101111111011110111000111111000011011111101100021012101000212121122a21220022220221001111111a11110111111011111001111121112122222210122121122102122121101
1101111101111011111111110111011011111111111111101001111110222210210220222221b21122122221112111111111a10111110110110111111111111201221220011112122222212101101111
1111111010111110111111110111101111111111111111111101111110110112211021002110b11121122110222221111110a11111011101011101110001101110110120221210110011221221021101
1111111100101011001110111101111111111101111100111111101111101112201122010112b22010121122101122111110a11010101011011111111111112202212011112221221221101111221111
1100101111111110101111111111001110111110011011111110110101111000200112221122a22121111122122110111111a10111111111101111111111121211110212022011220110122202211111
0111011111101111111011011111110111101111111110111110101110110111121210222011b11121112122202121111111a11100001111111111111110021011201112112201220201111200111100
2202121022211100022011121120111111110111101111111111111111111112101212111110a12111100221011122100001a11110111111011011011111111212220111212101022121110022121110
1110221002221220120111111112111001111110110011001111111111110012202222022202a11222111212220101010011a101111111110110101aaaaaababbaaababbbbababbaabbaabbbbbaaaaaa
2112110210102211120211112021101101110101010111111111111011101111121212111121a00220211121222111111011a111111101111111101a1110111101110111111101111110110111101011
1110022221210101201120101012111111110010111110111011110110101012221222011211a22212222121102122110111a101000101110010011a1111011111111111011111011101010100101111
2211220121112222221201110022111001111011101111111101101111111112012121002221b12211211101001211110110a111010111101111111a1111111111111110101111101011010110101111
1222120221001112110210202002111111111001010111111111111111111110221212211220b11121212221112211111111a110011101111011111a1111101111111110001111101111111011011100
1022112220012121122022111111110110111001111011101111011110111011211211201211b11122010122022111111110a111001011111111011a1111111101011111111111111111111111111111
0122012212111122111100222100100101100111011011110111111111101010121002202122a22121121101012212011101a111101010111110111a1110101110011101111110011011111111111111
1221211201012220221002112012101111111101111111111111111111011112211212222022b00022220122112212111111a111110111011111111a1101111101111111111010110111011110101110
1021222222120221121221120112001111111111111111111111111111101110111110010111a01101111010010101110111a111101011111101111a1011101111111101111110111110111110111110
2102001121202011121002121022111111101111110111111111111110111101110111101111a11011111111110110111111a011110111110111111a1100101101100110110001010111011111111011
2210020021121211021200112121110111110110111111100111100111111111111110001101a11010101111110111110011a100111101111111110a0011011101011111011110111110111110111110
0121201111222211221111220211111111111111001111111001111111110101111110110110a11111111011111011111110a111111111111011111a1111100101111011111011011111111010111101
2120111000122112111011021221110010111110011111111101110111011010011111111111a11011111111111011111111a101111111011111111a1111011111110001111011111111110011111100
0101122020022211111212222112011111110111011111111011100011111100111111111110a00111011111110111111101a111111011110110111a1011111110111011011111011011111110111111
0001111112212221121220212122011010111110010010111111111110111110101011111101a10111100111111101101100a110111111011111111a1101111111111111111111011111101110111111
2101021112221211112121012001111111110101111111111110111110110111011111110111a11101111111111111111111a111111111110111101a1110110111111100111110011001100001111111
0212202121001121212222212002111111111111101101111111111111111111111110111111a11111111111111111011011a110111101110111111a0101110110101111111101111111111011111111
2221122201101122212001122111101110111011111111111001011110111111101111111101a11111111111111101111110a101111101110111011a1111001111111110110000111101111111111110
2120022212221212112022021212101101010110110111110110111111010111011110110111a11111011111111111111011a101111101100111110a1111111100110111011111111111101111111111
2121212201112111111102221121111111111101110111111111101100111111111011111001a10111111101111111111111a111111101110101101a1111110010111111011110111111111111111110
0111021011101210102110121220101111101111111111111110111111111111101111111100a11011110101110111111110a011111111101111101a1111111111111000110111111001110111111100
2220111110221011010120022001111111110011111111100110110111111101110110110110a11111001101111111101111a110111111111111101a1111011111001001100111110111110011111111
1122011021122112202120010200111111111111010011111111111011111011111101111011a10111111111111111111111a111111110010101111a1111011111110111111101100011100110111111
1101112022020011112011110221011111111111111111101110111111111011111110111110a11111111101111111111011a111011011111011111a1111110111111111111110110110111011110111
2111220111221221011210201122111111110100111001111111111110011111111111111110a11110001001111111111111a111011111001111111a1101110011100101111110111111110111111011
2212122102201112111021211120001111111111111111111101111101101111111110101011a11101111101101110111211a212211122211112021b1021110111011111110011111110111010011001
0112101201100121022212102110111100111101100001011111111110111111111111111111a11111111111100111011212a102021122022112202b1111202211110010110111101110111111011110
1121221201022202222211102112110000111101111101111110101111111111011111111111a11111001010101111111221b222022112101122122a1001001011111110011100111111111111111011
2221121021222120211220201110001011111111000111111110011111111111111101111111a11111111101101100101000a200111010022111111a1222011111111011001111111111111111111101
1222122221212221112210210121111111011111111010111110011101110010111110111111a01111101011110100011222a222122111021110122b2211222011011010011110111010111111111101
1111001110111011111111111011111111011110111110111111111111110111111111111011a11001110111101011110212b122111120022212022a2012111111101111101110111111111010111111
0110111110110011111011100111111111110011011111110111111111111101111111111101a11111111011111111101010b022121211022111100a2121221211111111011101111101101111111101
1111001110111111110011111101101111101111111111111111111011011111011111111011a11101111111111011010110a212222112112111011b2122121111111111011111011111101111111011
1111101111101100110111101110111111111111011100011001011111111110101111111011a01111011111111111111222b011121211220202110a2112021111100111111111101111111111100111
1111111101111011111101110111111111110011111110111011110101111111111111011110a11010100111100111111012b211122202111012221a1102111211111111101111111111111010111111
1011111110110111111111111010111110011100111111011110111101011110111111111111a10111011111111111110201a102121221221210212b2221202111111111011110111111111111111101
1110110010111011111111111011111101111111111101101011111111011111101101011101a11111001111011110111021a212211111022222212a1120210111111001101101111111110101110111
1111011101111111111111111111011111111111100111111111011110110111110011111111a11111100001110111111022b122212111221210101b1022022110111111111111011111111111111110
1111100111111110011111001111111111111111101111011001010100010111101111111111a11111111111111011111111b011122211022212112b2022011011110000111111111011111111101001
1111101110110101111111101111101111101011111111101111111110100111111101100100a11011111011110111111112a112120212221221201a0100102111101110110011011110110111111111
1110110111111110011011011110111101111101011001111111101111111101110101101101a01111111111110011111211a221020100121200120b0222122111111111111111111101111110101111
1011111111111110101111110111011111111111111111111111111111110011111111111111a11111101111111111110220a221211001201021212a2211221110111111101101111010111111111111
0111110101100111001111111111101111111011011010001100111101111111011111111111a11011111111111111110120a022222121112212212a2211111211111011110101110111100111111111
1111111110001111110111111111101111010111110111111111111111111111111111111111a10111111011110100111121a022112102021111002a0121001211110000101001111111011111111111
0011111111110011111111101111111001111001111100110110110101111111111111110111a11010100011000100111200a000112221022202211a1201102111111011101110111000111111011110
1110101111111111111110110101111111011111110111101111110111110101111101111111a10111101101100111011202a202021000212221011a1210111201111111111101011111111111110010
1111011111101111111111110101011110101111111111111111111111011111101011111101a01111111111111111111012b211210022011121112a2220210211111111101111101111111111111101
1111111101000110111001111111001111111011111111110111100111110110011011111111a00111011111111111101020a211122022222102101a1202101111111011111111111111111111110011
1111010101011101111100111111111010110111011111111111101001100111111101111111a11111110011110111111211b220102222102212022a1100021111101111111011111010011011110111
1001011011101011110111111110101011111011111101110111111110111111111001111111a01111101111111110011122a110002112221122112b1221221111001111111111111111110101100111
1011111111111011101011111011101011111111111111111110111110101110111101111101a11111101010111100011202a212102211211021211a2210211211111111111111101111001111111001
1010101101111111111101101111110101110111011100111111111110111111111110111110a01010111110111111111122a120212111122112111a0221202210001111101111110001101111111111
1111110110011111001111111111110101111110111111111111101011111111111111111111a11111111110011100101211b120210002211210222b1020122111011100110111010111111111111111
1110011100111101111101011111101111111111001111111111010101111101111111110111a11011101110111111011201b010112210222221111a1212202111111011100111011111101111111001
0111111011101011110111111111111111011111101111111110110111011110110110111111a11010100111101111101220a120211221120222221a2222111011111110111111111111110111011101
1110011111111111111111111111110111111110011011111011100111100011110100101011a10100111111110111111110b102101122112022220a1112112211111101111111111010111111111111
1101111100111111111111111111110111111101101011111100110010101111011011111011a01111111111111111111110a101011111111111011a1100111111111011110111110111111111111100
0110111111111101111011111110101111110011011011111011101111111110111111100111a10111111111111101011111a111111101111111011a1100101110011111110111111011110110111111
1111111110111111111101111110110111111111111111111010111011111111111111010011a11111111011111111110111a111111111001111111a0110111111011111111111110000110011111011
1110110101111111011011110111111111111111101011101110101110101100111101100001a10110111110111101111111a111111111111111111a1111111111111110111111111101100111111011
1111111111011111110101111111101011111011111111111001111111100011011111111110a00101101011111000110010a111101111111110111a1010110110110111011111111111110011111111