82 104
12 11
93 70
65 53
30 27
17 18
113 105
85 4
141 18
41 25
01111111011001111011111111011011111101111111011010111110111111110110111211222002202012020010012b111121011101111111101010101110111111110011110101111111111101a111
11100110101111011110111101111111110111101011111110111100111111110111111211221202111221122111221a001121111110111111111101111111111110111111000111110111111111a110
11110111111010010111111111010111010101000111111110101101111111111111011022212201212011001001110a111121111101111001111110111111111111111111111111011110111111a111
11121122121001222202011200202021011101110111111111100111111101111111110211122211122201100202222b221211110111011010011111101011122022211121210222211112200011b111
11121110200211102022201011122120110111111111111011011111011111001111112201120212121111222022011b012121110011111001111111111111102211110122122122111201222110a111
11021222111222100002112022211220101011010110111111010001101101110111112210112222021001111000011b112211101111011011010101011001122011222021220111221121122120a111
11222202112201211221211120200001101101111111111001110110110010111111110020102211201122112102120a022211111101111111110111101001121202212201120012202102021211a111
00212210222000211220112122212120211111111111110101111111110111110010112102112122100112111111021b012110011110111111011111101101011011222020211220110001000121b111
11112001212122001212020120201222101111101101111111101111110111110111112101220212100100221021120a221210010111110011110111100100002012011112201002011111011122b111
11011221022120221221112222102122111101011011011101111111111011111111112021122211211011111021211a111120111110111111011111111011112120220212101201021111222220a111
11102102222101121211122220220110211020010111011220210111111111111010112022110020021112011200012b221021111011110110111110111111210111001121110111211201121212a111
10022122111210111122222211222222220221220210221221202111110111110111111112110210112222212111122a011101110110111111111111111011021111112122211121211210210211b111
10101221221120210022201122202012010211222212022111010211111110111111111121221101222212220020222b012121011111111110111110111111121102212212021112221202021012b011
11022120210122222000101111222222222120222021012021112210201101111011112112120010201121211012220b012021111111010101100111111111222201220210122111022122112222a111
11120211121220100222212211222022222022221222202221221122011011011111111112212010122201212221101a020120111101110011101110111101111212112222112022212201221111b111
11000201111222122112122212221220220220022222121112121112211111111011110201012111212002102122010b201110111111110111111110011110212221012112121211110221210121a111
11020122012112222002222022022222220211221222220212010222111111111101110000221211112220222121122a121021110011011111101101011110212221210121202201210111110211a101
11112011012120121221222010212222122222122222220211211122111111111111010110211211111102002121211b000111111111111010101101010111101011112122000011122221112202a111
11002111111102120121222022222222122201012202020222221121111101011011111121112221022211022200202b111121011101110011101111111111022111110021022110022001201001a110
11110112102100200220022021220122221120202221221211121201211111111111110011111122122010122220212a120011111100111111111100111001100222111121111112122110121201b011
11200212012212222211221202222001021222212221221122122222101110111011000101110111111111111011111a111111101111111110111110111111120101100222211221021200112210b111
11222212210122222022122022222220022202022202112021221012210010111011110111011011011110111111011a110011010011111111011101111011200120101212112221121021101222b111
11211122122012222201222222202122221112022202211112222100210111110101111111101111111111100111111a111100111111110111011111111111111002001221121122020121122110a111
11100211020221200120222220222212120221102122021002202121111011110111111111111111101111011110111a011111100111110101111111111111121101012011111111211022022222a111
01112222112102122222121021220221222122022222201001110012011110011101111111111111011011111111110a111111111111110111101101011111201121222111102211201021201212b100
11100102220112000212102022222222221222112210221220200122111111011111111111111111111101111111111a111101101111111111111111111011210211102211110012021122221021a111
11221110102121002222222222002222022120212021211120222112100111111111011111011111110111101111101a111001111111111111111011111110211012212221211221102202121011a110
11122122112021201210222222022221220222020221201011202111211111101001111111010110111111001110111a111111111111111110110111111111101111022221012021011122011222a111
11221221121221222222210212122011221222122222222112122012111111110111110111111111110110111111011a111111111111011101111111111100112212221122221201121221220020a001
11221010020220122212111022202222122210222212222100121100101111101111111011011101111111101100110a111101111111111110010101111110110210111112022122222201012012a111
10222122221021012122121210222022220222121210212220210010110111110111110111111011111011111101111a111001101100011101110111111101122211122110101022221220011221b111
10211210122112022012100222222020222022221201222000020121011111111001111010111101011110111111101a101111111111111111110111110101121002122121020112212111222102b111
11201211220121110120021212222221202022100222022112020102210011111101110110010011111110111111001a111111101011110111111111111111211221210211011210102121120222b011
10010221221210200222222221222222012122022112021220022012111101111010110110111111111110110110111a111110110111111111111101110111221120112211121202222021111021a111
11110111111111112101200222222200212212220122221011210212211011111111111111011110111100111111111a111111101110111101111100111101111111111111111111111111111111a111
01110111101101122110211011020112222110222021221110121011111011110110111111111110100010011101111a110111111110011111111101111111111110001011110111111111101111a111
11111111011111112212202012222222202222202221221110201222100110111101111011111010111101111111111a111010111111111011111111111110101111111111111110110111111110a111
11111111111111101212122122221200021220222002221122111211201110111111101111101011111110011110011a011011101111111111111111111110111110011111111001111011110100a111
11111110111010112211012002022212222110212111122101022222210110011211002121111021011011111010111a110110111110110111101101111111101110011111101111011110111111a011
aaaaaaaaaaaaaaaaabbaabbabababbbbabb210221220122112222212011022111110211122120112211101111101111a110111101111011100111111110100001001100101111111010011111111a111
1111101100111112221010021001201101a212120222211120221222021102122111121210211121111111011110101aaaaaaaaaaaaaaaaaaaaa1111011101101111111111111110111110111001a111
1001111110110112122222111111111211b01220211211111110022220211011002021201010122010111110111111111111111111111011110a1111110011111111111111111011101100110111a111
1111111111101101222211012222022100a21220021102111102212122121120120112212222112121010111111111111111111110111111001a1110011111111100110100101111111111101111a111
0111011111100010111011110111111111a11111111111011112022111122202112110221112121201011111111001111110111111111111111a1110011111101011101111010111001111111101a011
1001110111111111110111101101001111a11110001111100110212221222112221021120012210220111111100111110111111110011101111a1111111111111111111011111111111110101111a101
0011011111111110111101111111111101a11111111111110122121111122012221202211211111211101110110101111110111101011011011a1111011111111101111111111111101110101111a011
1101111101011011111111010111101110a11110111111110112221211021112201202021220221101111111111110111101101011111111110a1110011011101110111101111111110100110001a111
1101110111111011011011111110111111a11011111111011110211001221100221212012212001011111111110111111111111011101111100a1111011111111111110111111101111001101111a011
1111011010101000101111111111111011a11111111101011110110111102211212021201012010201101101111111111011111111111101111a1111111111011101011110111111101011111001a111
1101101011111011111111111111011101a11111111111111022112221121121021200011122201220101111001111111111111111111111100a1111111111101111101110110101111111111111a011
1110101111110101111111110101110011a11011110011111120102011221122122222201220212121111010011111001011111111010111100a1111011000011111111111011111011111111111a110
0011111111110111110110111101111101a00101111111111011211210111111112100012211012110111110110101110111111100111000111a1111111100111111111111111111110111111111a111
1101111110011111111111111011111011a11111011011111122012200121211201201122221021211111111110110011111101111101111111a0111111011111111011101011001011110110111a111
1111011110101110111110011011110011a01111111111110111112111210122021102121212100121110101110110111111011111010101100a1111101101111111111001111111111111111101a011
1101111101011011011001111111111111a01111011011110121220002212122111222122210112111111101010111111011111111101101011a1111111111101110111111111011110111111011a111
1110011111100111101011111111111111a11111111111011102210101111011201121220211012001121200102222212012002111222111011a0111111111001101111011111010011101111110a111
1111101011111010110111111111111011a00011111111111111211011222112021101011211221221220121121122111210202122111111110a1111111011111111111101111110111100111111a111
1101111111111111110111111111111101a01011111101011111212222022121110222222211212221210212221222100221220220202101111a1111111011010110111111111111110111111111a011
1011111110111111111011111110001101a11111101111111122201002021202112221022012112111122112211221212021111111212110111a1110111111111011110111001010101111111111a010
10111111111111aaaaaaaaaaaaaaaaaaaaa10111111111100111010002111022011122211110212220111221111111002221111212020111111a1111011101111111111110111111110001111101a110
11111010111111aaaaaaaaaaaaaaaaaaaaaaaaaaaaaaaaaaaaabababaaabbaaabbaaabaaabbbbabbbbababaabbabababaaaabaabbabaaaaaaaaa1111111111111111111111011010110110111110a111
01110111111111aa11111110111010111111111101111000012122111220122020010001221202022112122211101020210022120212111111111010100111111111111111111101011001111011a101
10111111101111aa10111110110100111101101111111111112021101211020002211012012200021210222221112012220111112120011110111101111111111110111111110011111110111101a011
11110111101011aa10111110110111111111111101011111102021121011222222120212011001212220112201212211122212122122011111110110011111111111111111101111101111010011a011
10011111110011aa11111111101101111111011111101110102212011102201222222120120020020212112221011201111002202222211111111111011101111101111100011111111110111111a110
01111111111110aa00111011110110111111111011111111001212022101222112111121201112222021221110102101222101212002210001101111111111101111011111100111111111111111a101
11111111011100aa11111011111001111101111110101101111111212000100110022111021020002022122221202222201121121112211001111111111110101111110111011111110111111011a100
11111101111111aa10111111011001101101101111001101101102121011212112101112101010222202222111102222121110001211010101111011110111011011110111101111111111111011a111
11010101111111aa11010110101001001111111101101010111210121001211121220101021211122211221002011211221102210001001110101111101101011100110111110111111111111100a011
11101111011110aa11111011111011110111111111111111110110110111111111111101111111102210011122200111122021212201111111101111111111110111111111011111111111110110a111
11110101111011aa10111010010011111011101100111111101111110101111101011111110011120212110010122012121121112202101111010111101101111010101111101111011111111011a111
10111101111101aa11011111101111111111111111010011111111111010111111111111111111221212022221211222011121112102211111110111111111111111111110110110011111111111a011
10111101110110aa11100111110111101111110111100011011010111111011111101111101100222201222210111221212222000122201101110111011101111101101111001111101011110111a101
11110101111111aa11111111110101111101111111111110111111111111111101011111111111021111202211210101111110221101101110011111111111010111111110101111111111110111a101
11111111111101aa01110111111111111101111111101110111111111100110111111011111110021012111012211120222101021111111101011111111111111111111111110110101001101111a101
01111110111011aa11111111011111111111111101101111011111110110110110101111101111102211120210002211121111212222111010111011111111011111110110101111100011111110a011
00100111101111aa11111010111111110111011111111111011110101110111011111111111111110212112112212201111022102111011111101111111111001110111111011101111111110110a011
11111110110110aa10101001111110111110111101111111111110111011011011111101101010111111222122200222122211012101111011111111111011111001111111111110110111101110a111
11110101010111aa11111101111110111011110111111011011110110111011111111111110101021101100122202111012112100011111011111111110111111111110100111110011111110110a110
11111111111011aa1111111011101011111100101011111111111111010011111aaaaaaaaaaaaaaabbbaabbabbaabaabbbabaaaaabbbbaaaaaaaaaaaaaaaaaaaaaaaaaaaaaaaaaaaaa1111011111a011
11111111101111aa1111100000111111111111111111111010110111101111111a1111111111111220111021010201210210101102212101011110111111111111111110111111100a1111010101a110
01010111111111aa1011111111101111011011011011110111111001110111111a0011110001110222110211221012100121002022221100111111100100111111011101001111100a1111111110a011
10111110101111aa1011101101111101111111110011111111111011100101111a1111111101102122122110121020200211212211112111111111101111001101111011111111111a0111101010a111
11111011011010aa1111100101101111111111111111111111101100110111110a1111111011111122121220101212122112221101011111101111111111111011111111111111111a0111110111a110
10100111111111aa1110101111101110110111111110110111011111110111111a1110111010012022211111112122100111122121011011101111111111101101111011111111111a1011111110a100
01111111111110aa1110111111111111111011111111110111101010111111111a1111111101111110010221112001120112212210212101111111011001111111111110111101111a1111111101a011
01111111111111aa1111101111111001111111110101110111111111110001111a1101111011110111110111111111111011111111011111110100101111111111111110111110111a1111011101a111
11111101110011aa1110100111111111111111111111101111101111101111111a1111110111111111110111100111111111101111111110010101010111101011111101011001110a1111110010a111
01111011111011aa1011110001001111111111111101111111111011101111110a1111100111101110111011111111111101101111111111111110110110100011111111111011111a1111111101a111
00011111111110aa1111101001001111111001011111101111111111101111011a1110111011101111100011111111111101011011110011111101011111111111101001001011111a1111111111a100
11111011110101aa1111101101000111011101011111110111110111111111110a1110111001101011111110111111011110120022112102101111221121110121111111111111010a0111110100a101
11111111111101aa1111111011101011001011100110111111111011011011111a0100001010111111111111111010111011212112111211111110001102120011111111111101101a1111111110a101
11010111100000aa1111110111111011110111111101110110111011111111111a1110111111101011111111001111111101211122211010220202020121120111010111111111111a1111111111a010
10011001111111aa1001110111100111111111100111111010111111111111101a1111111010111101010001111110101112121201121212102010012222001221110011111001011a1111011001a111
11011111100011aa1111111100111110111101111101111111110101111101110a1111111111011111111011111111111111212111211021122120221101101120111111110111111a1101111111a101
00110111011111aa1111010100111011111111011001111011111111111111111a1100111111111111111101011111111122221222021122022012101112111221110111110110101a1111110001a011
10001111111011aa1111111101111110111111101001011111111111111111111a1110110111111111010110110111101121122110111211012112111122222111110110011111100a1100001101a111
11110101111111aa1110011111101111111011101111111101111111111110110a1101111111011110100011101101011111020011201111111121022221122021111111111111111a1100010011a101
11111111011101aa1111111111111111111111111101111111101101111111110a1111110011111101001111111101101121022101212121011212120112112121111111100111011a0101011111a000
11011111111111aa1111111111111110101111111111110111010111011111111aaaaaaaaaaaaaaaaaaaaaaaaaaaaaaaaabbabaabb021122212202122201000021011111111111111a1111111111a111
11101111111111aa11011111111111111111111111111111111111101111100010110011111100111111101110111111101201222b121221200011222201211011001111101111101a0111111111aaaa
11110011111111aa11011110011111011111111111111111111111111111111111110001010110111101111101111001002211002a100202112110122110110120100100111111111a11111111111111
11111110111111aa11111111110111111100111111110011011101111110111001110111110111000010111111111111101010012a111221122021012201210121001101111111111a11111111111111
10100011011011aa11010011111111101101111111111111111111110111110111100011110010111100111111111001101122202a101211120122112020022101111001111111101a11011011011111
00101111101011aa11010111111110110111111111111101111101111011110111101111100011011111111111111111111201112a211122222202112211202020111111110111111a11111111101101
11111101111111aa01111111111110111111111101011101111010001111111111101110111101111011111101101100112220221a201112121210021101021101101111101001101a11111111010111
00111111101111aa11110111111110110100111011111111111011111111101101111101111111111110101011111010011211201b201100112012111121222201101100111110011a01111111001111
11111011011111aa11110111111111111111001111011110110111111111111111011110111111111111111110110111001202221a122012212102122012111121011111111111111a01111111111111
10101110011111aa01111111011101111111111111111111111111101100111111111110111111011011111110101111112202110b102101122020121221210221101110111001110a01110011011011
11111101111111aa11111111101100111111111111001010011100010011101011011111111011101111111111110111001210122b122012121012111211222221011001101111101a11111111111111
11011111111101aa11110111111110110101110111111111100111111111111001100111011101010011101111100111111111020b110110011122111211120220101011111111111a10011110111111
01011111111111aa11010111111110101011011110011101111110111111111111111110111111011111111111111111000200212a212220111211121211222021111101011110111a11101111111110
11111110110110aa10111101100101111111011110110101101111011010111011111110111111101010111111011111111121000a112010111221212122222111111011101011111a10101101110110
01101100111111aa10111011011111001110111111110111011110111111111111111110111111111011111101111111112112211b221212121102121112221001011111111011111a11111111111110
01111111110111aa11011110110111101011011110110110111011011111011111111011110111111110111011001100111022222b111200000021111021110201111111110111101a10001110101111
11111111111101aa11111101100111111001010111011111111101111100111011100111111011101110100101111111112120012b011221210112220121211210101100111111101a11110111111110
11111111110111aa11111111101101111110111111111101111011111111111110101111111011111011101011111110112111222b121010021212202210112101101011001111111a11011111001111
10111111110111aa11111011111001100111110101111111011011111110111011110111111101001010111110111111112202222b122021221112111211200121111111111111111a01110111110111
11111111111111aa00101111111011011111111111111111111111011111110101110111111101111111111111110111110010012b210022012212222121202110100011110110111a11110111111111
10111111111110aa11101110111010001100111101101111111001111011011110111101111011111111111111101010011010010b202101211222102112222101101011111111111a01011111101111