90 118
9 42
131 15
64 47
56 103
85 87
5 24
80 91
11 46
152 32
11111011111111111110011001101111011111110111111110111011111111111101111011111a111111101a111011101111111111111100111122101001112222222212111212112201111111111101
11101011101111101111111111001110101011111101111101111101111101101011111111111a110110101a111111011011111111111111110111110212212222200011211122200120111110111001
11111101111110111111111101110111101111001010111110110110001111010011111111110a001111111a111111110111111111111011111122112111200120012222102222012201111111011101
01001111111010101111101111101111111111111111111111111111101101111111111111111a110011111a110011111101111111111111011121212022001122201222211102112021111101111011
11110101110111001111111011101111111111111111001111011110111111110111101111010a101111101a111111111111111001101111011111211022111012211022111221212101111111110001
11110111111011111111111011011111010111111010111101111101111111110111100011111a111111111a101111111101110111011111111021210112121022211200112212200211111101111111
11100110111111101010111110111110111101111111011011100110111100111111010011011a111111111a101111110111011111110111111122212212220212222112122101212221111111110111
01111111101011011110111011010100101110111111011101011110111111101100001111110a111111111a111110111111111101101101111102012221201122212201100220101221011111011111
01111011010111110011111110111001111110011111111110111011011011011111110110101a100111111a111111111110011111111011110112000211020101101112121001101221001011110111
22222102011122020221101111110111111101111101111011111101111110110111110111111a111111111a001101011011110011101111101122010221111002220110121121102121010111111101
10222221122022100220110101110111011011111111111010011111111111111001111110101a011111111a110111111100111111011111011110020211211122021011122111112210111101111110
12211202112220111212110110111101111111111110111011111001110111011110111111011a111011110a111010111010100110101111111121010202122210221112111012101111111011110110
11122122201222221010211111110111111111011111001101101111110011111111001111011a111111010a110011011011111111111111101121020102001102012002222001112121101111111111
22101222121021011021101111101111111111111010101111010011111101111101111111111a111100111a111010110011111011110000011021011221111221220221100020102201111011101111
02221121201110111212110000111101111111110111001101010010011111111111011111111a011111111a101101010110110110111110100011022222211122102011012201010221111111011100
21012122021122112112111011101111101011110111111100110111111110010010111111111a111111111a110111111111111111111111111111122011121211222111002211102111101111110011
01102210210012120202011110111110111111010111110011100111111111111011011111111a010011111a101111100111110111110011111012112011121110122202220122222121110111101111
10002221212122021011111111101111101110111101111111111110110111110101111101011a111101111a110111011111101111111010111112012122110102211011102100222212011222012012
20212122202220210022101111011111000010111111101111111110110111111011111111101a111111111a101111111111111111101111010001110020111002112021202222212211022022212011
11211222012211210222110111111011011111110101011101111111001011111101111101101a111100111a111111111110111101111011111122020202211111210012221221221121112101221112
12210111121112121112211111110111110011111010001011111111111111011011011111101a111110111a111111011111101011111110010111222120111112222222021220221122201121021201
02101120202211222111011101101110111110011101111011101101101111110110101100111a110011101a111101111101110111111011101110120112221211121112220212122201110201111211
21111100110220011012000111011111111111010111111111011101100111111101110111111a111111101a111111111101111111011110111121222101021220121212220222101211011212120122
12102120221111122221111100111111111111111111101011111111111111101111111111101a110110101a111111111110001011111110111111021201221021122021221222201222011100202212
01121112121220202202011111111101111110101101111011111111100100101111111011011a011110110a111111010111111111101111101121221122000222122120112221222221120121212101
10012212011211001101211101011011111111101101111101110111111111101111111110111a101111111a011111111011111111101111101020121120110212100202121222222202200211011112
00012112221211222020111010110111111011111011111111111010111111011011101101111a110100111a111011011111011101011011111102211221021222021022121112222222222012022112
01122210111210012001111111111101111110111111111010110111111111110111111111111a111111111a111111111111011111111011100010121211102200021222120212220201220112212221
12211211121121001212201111110110111011011111011011011111101110110111111101110a111110101a011111111110110101011111111110011212101102012211112022220212020110122222
12102112201122121111211101111110011101111111111100111111110111111111111100001a101111111a111011010111111111011110101122222211220221210010222220012222122121211212
21022002222011111102201111111111110100111111111101011000101101100111011101111a111011111a111110111111111111101011111121221221102122021212122200222220211122220102
22200200120221120112212010210111011101101110111111001111111011111110010010111a101011110a101010110101111011111111011111101011111111111111112111121100122221110111
02001122112202021222201221111110011101111111111110202011022100211201211221221a221011100a101101011111101101101000111111111011111111101111112112101100112122111022
12201022022102022222221102211111111111110101111102212201222012200012110221222b120111111a110110111110010110110111111111111110101101100111100110220211220200122212
00122220222022121221210211100111111111111111111110211201012002120021212211112b121100011a111111111111011011111101111101011101111111011110112112111220112112112202
22121222222222122212020112211110101111110111111101201112112210022212122202212b201101011a110011011111110111011110111101111111111111111011112210102220211222100211
22120102211122220222220121111101011011111111011110021112020121221221222120102b111111110a111111111110110110111111111110101111101101110011112222111120210221120120
22202222220222102002212120111001111111111111111111202221220112222212011221212a111111011a111111111111101111011111011111011100111111110110101212010110211122112021
21012221212212222221200121011110111111111111111010021222112221020221121120102b201111110a110111101001111111111011111111111111010111101110122112111020020010112211
02212202112222012020212211211111111111111101101111001210212222211012011102111b121100011a111111111111101110100111111110111111111111011101120012222210201102121102
12122102011212112120200112111101111111111111111101122101121121012021112101201b001101011aaaaaaaaaaaaaaaaaaaaaaaaaaaaaaaaaaaaaaaaaaaaaaaaaaabbbbbaabbbaabbbababbba
10120211012120022022101201111110011101101111111012011210121112102202112110111b1111111111011111111110101110111111111111111111101111011111022222022120111101122010
01011201121210122101122012111011111111111110111111010002221220221202002120221b2211100101111001110111111011111011011111011110111111101111100210101021222121100212
02001121211201120011120221111110011111111101101112122212121212112221022122122a2201111111110001111011111101111111111111111110101110011111112210201202212112212202
01200122012221210221222020211111110111111111111112101021210221111111120010212a0111110111111101101110111111110011111111110111101111111010012100112120210120211112
11210122012201221122212010201111011111110111111102100121102211212222111121202b2111111111011111111110111111110111011111011101111111111111121021122212121022222012
20102212212210101002122111011110111111111011111012122022212221222020210022111b1211111110011111011111111101011011111101111111110001111011111101212201202120012102
02111210012201212122211101211111111111111111111111121211111212201011120112021b2111010111111011111111011111111101111111101111111111101111011200211122210211022201
11211210222202122012011220111111111111111111001010121011220210102121221112110b0011110011101101101011111111011111010101001101101001001111111111101111111011111111
12210221121212111202112111011111111111011101111111022012110122212221011112222b1111100110111111111111111100110011100111111111011010110011111111110111010111111111
12021101012201211112120012111111010111011111011112211221211121112221221122121b0010110111111011111111111101111111101111111111011111111111111111111100110111110101
21221012200121012221120021211110011110111111101001122212211011012220222112111a0101011111011101101011011110111101111011111101011111111100111111111111111111111111
22021001112212011112110211111101111111111111011011100121022112112212111122122a2111110011111110111101111111100110111011110101111110111111111110111111111010111111
11012011221121101120210101201111111111110100111111221111222101211222012210112a2101111111011111111111101001111011100111111110101001111010011110011111001100111111
21212220010220221202022100211100111011100010110111201201221122012220122201210a1101111111011111101101101111111111111111001111111011111111111010111011111110110101
20112221120212222211222221211110111111111111111112221121201112211122121112201b2211111111111111110111111011111111101111111011111111110101111111011110101111111101
21112012202221111011211022011111001111111111100100210202121201111110101012220a0010111110111101111110111111100111011110111011110110111011101110010111111011011111
bbaaabbbababbaabbbbbabbbbabaaaaaaaaaaaaaa001101102221122220111201222121212002a2011111101111111011011111111111111101110111111101111011011111011111111011001111111
2211112012112111102021002111111111011111a111111110121201221111020120112111020a1110101011110101110011111110110101111111111111101010111110101010111111010101111011
1112111212112211220210011021011000101101a100110112211201211220102001220121220a1211111111011110101111101111111001111111101101101101001010011011111111111111111111
2212020110112222201111102101011111110010a111101112221011211002120211222012010a2110111110001110111110110111111111011111011101111011111011110111110110111110111010
1120202201200022111210110221111011111111a111111111121211122211011101012211110b2001100101100111001101111110111101011001111101111110111110111111011111110111001101
0111110011111111111111111111101110111101a110111112120210222001122112220212012b0211111110111111011111111111111000101111111111101101111110100110110111111111011111
1111010101111011111111111101110011101011a101111111011001010111111010111011101a0111101111111111011111110111101111011111011111010111111111101011111101101010111111
1111111100101110111111111010111111111111a111111010111101111011111111111111011a1111111110011011111011111011111111111111111101111111111111110011011101110110100110
1111011101110111101111011101111111111101a111101111101111111111111010110111110a1111111111110111110101011111101011011110110111111111111010110111111111110111110111
1111101111111111111101111101110111111111a101011101111011101111111111111101111a1111111101111101011101000111011111011111011111111111111011101011111111101101111010
0101111111111111111100111100111110011101a011110111111111111111111101111011101a1101101111111111101111111011111111111111111111111111110110111111110111011111111111
1111010111110111111110111111111101111101a111110101110011110111110010101111111a1111111111111001111011111110111111111111111100001111010110011111111111110111111110
1001111111111111101001111011111101100101a111111011111111111110111111101110110a1111111101110011111111111111101011011111011111111101101101100aaaaaaaaaaaaaaaaaaaaa
1111111111111111111110111111111110110101a011011110011111101110111011010111111a1100111111111111111010111111111111111110101111111111111011101a1101111011111111111a
1011101101111011110111110101111011111111a111111110111111100110111101011111110a1111111111011111110111101101011111111111111001010011110111011a1111111111111111111a
1111111101111101111011111011111111011011a111101111101111111111001111112202201a2101221121022211112212210111111111111110111101110111111111111a1111111110111011111a
0110111110011111111111111001101101111111a111111111110111010111110111010121121b1111111121011121221100210111111111011011100001011111111111001a1011111111110111101a
1111111111110111111111111101111101110111a111101011111111010110111111101120211b1111111222121102221012111111111111110111101111111111111001010a1011111111111111111a
1011100101111111111111111110111111111101a110111111111101111001111111111120202b2210220122220022212202211101100111011101111111011100100111110a1101010111111111000a
1101111111101111111111111111010111111111a101111111111101111101111221102202122b0222121122222122121110110111111111111101011111111110011111111a1111111111111110111a
aaaaaaaaaaaaaaaaaaaaaaaaaaaaaaaaaaaaaaaaa100110101111011111111110010212222010b0220102112212121222210111011111110111110111111110110111110110a1111111111011111101a
00111001011010111101111111111111110111010111111111111111111110111221222220211b1122220222102122221211211111011101110101011101111101111111111a1111011110011101111a
11100111111001001001101111111100111101111010111001111011101011101212112200022b2022212210122202212101201111111111011111100011111111111101111a1111101110111110111a
10011111011111110001100011100011111111111101111111111101111101111010020101112a2120111101202211221212011111110111011011111110111110101111110a1111111111111111101a
11110111101011110110111101111111111111111111111010001101011111111021102012222b2202222222222122010121111110011111111111111111111111111111111a0101111111011011111a
11111011111111111101111101110111110011101111110111111111111110111001212222222b2022122221212202122101211111100110111111011111101110010111111a1111111111111100111a
01111011111111111111111101011111111110101011101110111111111011111112112021211a2112221221221222122212011100100111111111011101101101110011101a0111111101111111001a
01001111111011111100101111111111111110011101110111010000110111111121112221211b1022201200222222211212011111111110101111111011111111110111111a0111111111101111111a
10011011111011110111111011111111111011001011011111001111111111111211012220220b0210202220012121122111101111111111110011111011101001111101111a1101101011111010111a
11001001111011110101101111101111111011111101101111111111000111111220112211112b2202222002222222212202111110011111111001111111111111111111101a1011011011111111111a
10111101111101110101110111011001101111111111101011011111111111010221102222022a2200102002222202221021011111111110111011111101111101111111111a1111111011111111110a
11111111011111101111001001011111111111111121120201122101111022212222222222222b2222222222222222201010111111111111101111111101111000011011011a0100001111101101110a
11111011111001111001111111101111111101110122111101211221010222111102222221122a220022121222100100110baaaaaaaaaaaaaaaaaaaaaaaaaaaaaaaaaaaaaaaa0111011111111111111a
11101111000110101111101111101100111111111121210221011212220220221202111202122b122202212120201022011a11100011111101111101110111111111111010110010101011111111111a
11011110110101111111011110111111111111011200120212112220021001112212120220220b120222212121222012120b11011111111111111101111111100101111101101111011011111111011a
10111111111111110111000100111111111110011121112211112022020021112222221102122b022222220222220120022a11101111100111111111011111111111011111111111111111111111111a
11111111110101101101101110100011111111000200222120212222211012120020222221122a122202201222201110221a21111111101111111111110111111111110011110111011001110111101a
11111111011111101101111011011011111011111221121012002121012120100101202002012b222221022220022222102a21111111111011111111101111110111110111101101101011111111001a
00111111111111001111101100011011101011111111001122111222221202200221200202202b122000212221222222100b01111111101011110111011101110110110111101110111111111110111a
11100111101111111011111111111111110111101121121212221100221000220122122220202b211222022012222202120a11111101111111111011101111110111011011101110111111011101111a
11110111011011111111111111110100111111101202121222122221100212121222212121222b122202222222122222021a11111101101111111111111110100101111110111111110001101111110a
11001100001011111111010111101111111110011102012012121010222122121200220222210a122222212221222112122a21111111001111111001111110011101111010111111111111111110111a
11111101110011001111110111111111101111101110222110122212111001200021222022122b220001212020111210101a11111111111011001111110111111110100110111101111011111111111a
11111101011101101111100011111011111111011121111111021021112211211121202222112a002212222200221202021a11101111111111001010110101011101011111100111111111101011100a
11111011101110111111110111111111110011111012211202222101112022121021222222021a201022222022220222111b21011111110111111111111111111101011111010111111111010100111a
11111110111111110011111101011111111001111110102200211211201111221200022021222b101220022202212121012a21011111111110111011111111011100111111110110111111111011111a
01111101101011111101111101111111011111011120112220211201112101222222010200022b222221012110201212111a01111111111111100011111011111001111101111111111011101110010a
01110111110101110111011110011111111111111220122120112221221011222222202100221b112211122201122122111a11101110101111001110101110111011101111111011101111110101111a
11111011111111111110001111111010111111100112112202221110222222111222122011221a110222112012212222111a11111111111111111111001100101111010111111111111111010101110a
11101110111010110011011111110111011110111011111111122022211112112102222222202b111112221020012202111a11111111110111110110111101001011111111111011111011101111111a
11010101101011011111110111011111111011111212221021122021210122010122111011111a111111011101110111111a11011101101111111101111111101111111101111111111111001110111a
00111111101011011110110110111110011110111201212221012201211211221112201101111a011111011111111111011a11111111000011111111101111111011111010011111111111111111001a
11110111011110011110110111000111111111111200122210110212221011100212112110111a111111101111110110011a11111111111111111101111111110111111011110010010011111111011a
11111100111100110111111111101111111111111112111110212012021011211211212011111a110111011111111111111a110111110111111111111011101111101111010111111111110111110101
10101111010101111101111111101111110101101212112201220211212021212022222211111a111111111110110110111a111110111111111111111101111111111101111110011111111111111011
10111111111111011111111101111110111111110212121112101102011102102012122211110a100111111111101101111a101101111111110111111111111111111111111111101110100111111011
11110100111110110111110111111111111011111212011022202121011211022210111111010a111111110001111110111a111100011111101011101101111111111101010111110111001110011101
01111111111100111111011110111101110111111112211122022111110210002221012211111a011111110011011111110a111011000011111101111011111100111111111111110111110111010101
11111111111111111111111111011111110111111112212011112221222112001121211211110a111011101111100101111a010001111111001111111111001011110011001111010111101111111111
11110111011111110111110101111111111010011211122122222121112121122102212111111a011111010111111001110a111111100101111111101111011101101111110111111011101111001011
01111111110111111111111110101111111101111121212212111112010111012120222211111a111111101111111111111a111101111111111111010011001111111111111101110011111111111011
11111111110001111011110001111101101111001110111122221201220102112110001211101a001111111111101111100a011111110111100101101101111111111101101011110111101111110111
11111111111111101111111111011111111011110100010101011001111101111111111111110a111111111111110011110a111111111111011101101111110111111111111101110110111010101010