1 85
140 30
117 53
152 92
129 77
100 50
84 107
88 2
40 18
120 116
1111110111a1a10011111111111011110110011111a111111111110001111111111110111122111221102121011122200220022111001100011111111111011111110110010101111111101111111111
0100111111a0a11111111111111000111110111111a010111011111111111001111110101120120121121102221222212120021011111111111111111001110111111111111111101011111111111011
1101111110a1a01111111111111111111001101110a100111111110011110100111111111220210012020222121011122220112111111111111111011011001111010111100011111011011111110011
1010111111a0a11101111111111121111201222202b120212102121201101111111111111022221111122210210021100111012101111111110110111011110011111111101111111111111111110110
1111010101a0a01110111111110121011211121222a110101201220011111111111101111212022002212120121211121222012201000100111111111011001111011001111101011111010110110111
1111001101a1a11111011110121121211121211220b210121212011211111011011011111112121222112122011101110012021011111011011101111111011011111111110111111011111111101111
1011111011a0a11101111010121101022110211121a120102121122211000111011111101001121121212000212111122211001201001101011010111101110111111111101111011011011111101110
1111111101a1a11000111110101212222220211210a122101122202211010100111110111222112221010011121201120211221101111111011111111111001111101111110101110101111111101111
1010001111a0a11000010111111111100212122220a121020110100211111111111111111200210221110120122121201202222211100110111011111111111111111100101111101001111110111101
1110110101a1a11111001111102112222211112112a212220022022211111110110011111212100210120201222222001011122210101000111010011011011110111011111111110101101001100101
1110111101a0a01111001111101212211222110101a101002122100001101101111110111211110222221212021122022211011111101111111001111111001111100110110111011011111111011110
1111110110a1a11111111110100011021222201102b021210022111201111001110111100002221212212212122012212112120211010111101111111010111101010011111111010111111101111111
1000111111a1a10110110110022220102221010022a010120111111101101110111111111112021121102011210012102112220111111011111111111111111101111001111111111111111111011111
1010111111a1a11100110110111112200111100221a012202021220111110100110111110220202210011120212211012121010211111011011110111111101111011111111111111101111111110100
1111111011a1a11111111111111021212202222112b211110202212211100011101011110112111221212110102222000212212001111101111111111101111010111101111111111111011111011111
1101110011a1a01110011111101002212102021111b212122002110111111111011111111221021122220120202111110202201210111010111011111101001111101111111111010111101011111111
0111011110a1a11111111110120222212011221110b222210021122001111100110111011200222221202220212102222202011001111111111111101111100101111111011111111110101111111111
1111111011a1a11111101101122200222122101201a102112212021111111101111001101212122220122120021110022002221110111101101111111101111111111100111100111111110111111111
0110110011a1a11111011000121112122002012010b111101210212211111111101111011001110001111111110111111110100111101111111101001111111111111111111111111111110001110111
0011111111a0a11111101111110120121211221222a121010210202211011111111111100101111011111110110110111011110111111111101011111111101111101111111111111111011111111010
0111110011a1a10101111101121112212022220121abbaababaaabbbaaaaaaaaaaaaaaaaaaaaaaaaaaaaaaaaaaaaaaaaaaaaaaaaaaaaaaaaaaaaaaaaaaaaaaaaaaaaaaaaaaaaaaaaaaaaaaaaaaaaaaaa
1101101110a1a111111111110202222122212112112220110212011210011111111011111101110111111111111011110111011111111111111101101011111011111111111100111100111101111111
1111101111a0a111111111101220101121220111220100111122120211111111111101111111111111110001001111111101110111111111111011001111011110111111011111101011110111110111
1111001111a1a111111111111212012120021122221200122012220211101110011101111111111111111111001111011111111111111101111111111111111110011111111111111111011100001111
0110101111a1a111101111011111121112101012010211111201111211111111111101011111011111101111111111111111110111101101111011111010101011101111111011111001110101011111
1110100111a1a111111111110110122112011121220020222200220000111111111111110111011111111111011111011111001011111111111111011111110110111101011100101111111111111010
0111111111a1a111011011111110212221212201002112122112102210111110111100111011111010111111111011111110100111110111111111011010111110111110111111111111110100111111
1011011011a1a100110111111212101112202212100212212110221101111111111111111111111101111111111111111111110111111111110101011011101110101100111101101101101111111111
1111101110a0a111011111110212102122121120112011002221121011101011111011111111011111111101111111111110111011111111111001111111100011111101011111111110111111110111
1101111100a1a101110110101111211011021121221112212011121101101111111101111111101111101011111101110011111111111101011100111111110110111111110101111011111111110110
0110111100a0a111111011111112022110121211200220211111100111101011110011111110111100110101110001111010111111111110110011111111001011111100011110101111111110111111
0011111111a1a111111100111011111212112220222002220112122011111111011101111011110111111101001111111111110010001011111111111111111011101011110111111100101111111011
0001111111a1a110011111101212112021201212202110221111201010111011010111111111110111011110011110110111101111111111101110011011111111110111011011111111111111111111
1111001001a1a111111110111202210212110121121212110212112011111111111011110100111111011101010101111110111111111100011110111111111111010010111100111111011111111100
1101111110a1a011110111111111111111111111111111001111111111110111011111110111011111011111110111111100101011101011001111111111101110111001111111110111111111111011
1111110111a1a111011111111111111111111110111011111010101111111110111111110101110001111211120111021212122112020212210211111111101111111111111011011011101111011111
1101111011a1a111101110011111111111111111111111110111111111001011111111101001111111011121221112212221212220210221221101111111011001101101111110000110111110111101
1111110101a0a101111110111111110111011111111111111001100101011111110010111111111011010201212020101202021221110212221111111111111111011111001010111111111111101011
0111110110a1a111111110111011111111111011111001111110111111011111011011011111111011111222222002210211200102022220121221211110111202221011101111111111101111100111
0101110111a0a111111111111110111111111111111101111111011111111111100111011101111101111121112212122121100221122122222111111121221002012111110111101111011111111011
1111011111a1a111111011011101101111101011101011110111111111111101101111001111001110100221112221220022102212222202211201121101122122212101001111111111101011011111
1101111101a0a111111101110111011111001110101011111101110111101111111111101110110110111112220212012121122222200212222221212022121122110111111110111011111110100001
0111111011a1a110111111111111011011111101111110010111011101011111111101111101110011011121110021101202212220222201022201221120111101111011111111011100111011111111
1111011111a1a101111011100111111101111111110111111110111111111011101111001011100101111111212221000202212220202202122002122010122121112101111111100111011111111111
1111011101a1a111111111111111100010100111111101110110010111111111111011111111011110011222112222220212202222012110100121021021122211020111111111111010111011100001
1110011111a1a111111111111110111110010101111010001111110110011110100110111011110111010212100010112112012222122222000101010112211102211111111011011110111101111111
1101111110a0a111101101111111111101111111110111011001101110111111111101111111101110011222201211201120112222102221222110101202111222111110111111111110111111111111
1110111101a0a111011111101111011001111111111111111101111011111111100111100111110111110022222221011122112112221221202112111120112101212111101101110011111111111111
1111111001a1a001111111111110111101110111111111011101100110011101110110111011011111111222100222211112202222202102122202220001202022221111111010111111110011110111
1111011111a0a110111111101101111110011111111110001111111111011111111111111111111101101122021002222110221222022220020221212100111222201111011111111010111111111011
1111011111a1a110111111111111011111011111111111111011101111111110111101101011111111011221020001122211122221200022220122212211211111002011110111111111110111111001
1001111101a0a011101111111011100011111111011111110111101111111111110110111110010001111111110222021201021120000110112211002112102212120111111101111111000101101110
1111111111a1a111011111110001111100111111110111111111111010011111101101111111011111111101222222201102222212222112120022122211222222222101011110111011011111011111
1100111111a0a111111111010111111010111011111111111101111111001111111001111111111111011011122121202211222221012122220221102122221000122011111011111101101110101111
1111100001a1a111111111111111111110111111110011011110111111111100011111111101111011111211121121112222222200211220222121220111220111112111111111111001101011111110
1111111111a0a111101011011111111111111111111101111111111111111111111111110111010111110102202121222101021202211011211222022010022212212111110111010110111111110111
1111111111a1a110111111101110111011110111111111110110101111011111111000111111111111111201212121100212111202122201222210111221100220211111011110011110111011110111
1111010111a1a101111111101111110101111111011101111011111101110111111110100101101111110201101101121222212221212200221220011212111112011110011101111111011111111100
0110111111a1a111111111111100011110110111101110111111101111111010111011101111111011001211200121210002121002022012201121212001221221022111110111111111111111101010
0011101100a1a111110111111011111011111101111001000111111001111111111111111111110111111211212111212202202122021222210212221211101112101011000011110110111111111111
1111111011a1a111111111101101101111101111111110001011111111110111111101011111110111111002121112202211111201021022221220221220010210111111111111111110111011110111
0111101111a1a101011111111111101111101101110111101111111111101111111111101100111111010011210022011202112202221222211200111111202120112111101111101111111111111111
1100011100a0a111011111110111011011011111101111111111111111111111111111111111011011111212121210102211010222222120222002222122200222122101110202020110111111111111
0111101111a0a1111111111001101111101111111011111111110101011aaaaaaaaaaaaaaaaaaaaaaaaaabbabababbbbbaaabbbbbabbababbbbbbabbbbbbbbabbbabbbbbbaabbaaabaaaaaaaaaaaaaaa
1111101101a0a1111010110111111110110011111111011011111101101a101110111101101111111111112100212200221221222122112221200222200212222200220010102111101101111101111a
1110110111a1a1101111111110010111111111111110111100011011010a111001011111101011111111111122220202211112221022212102200222220201202222100120010012111111011100000a
1111110101a1a1111111111111111111111101111101110110111111111a110111111111111111111011111111111111110101111222101122022122202220122210221112000211210111111111101a
1111100111a1a1111011111111111011111111001011001111110101111a011110111110111111010111111111111101011101010012102102212220222100122222222212212112110011111101101a
1101011111a1a0001111111111111111101011110111111011011111110a111111111100111011110101111011111001111111201001121221222112222222222112202212012111211101100111111a
1011111110a1a1100100111101111111111111101111011111111111111a111111110111111111111111111101011111111001111011111111122211110221022221112201110200211111001111110a
1111111101a1a1111101110111110111011111111011111011111101111a111111011101110100001110110101111111110111101111111100211100201200022122220011102111211111111111110a
1111111111a0a1111101111101011001111111101101111011111110111a111110111111111011111011010011110011011111111111111101012121222022200111221200121100201101111011111a
1101111111a1a1111110011100110111111110011001111011111111111a111011111001111111111111110111111111011110011110111111211201111212011111120112121212210111011111111a
1111011111a0a0111101101111110011111111111011001111111111111a011111101011111101111100111111111011011111110011111111110211222101121101221211110201011111111111111a
0111111111a1a1111100100111111011111111011111111111111011111a111110111110011111111101101111111111011111011011111111112202222012111222211121002211101110111111110a
1111111001a1a1111010111111111011011111110101110111101111110a001010100111101110111111111111100101111111111111111111200111222122121011222221120122011011111101111a
1111101011a1a1111111010111101110111111101111111111111001011a001101111100111111111011011111101111111111101010111100122212122221222002102201121121211101110111010a
1111000111a0a1111111001111111111001111011111111011111011001a010111001111010011111111111111111111111010101110101011111101211012121102111112122200110010221121121b
1111110101a1a1111111111110100111111110110011111110111111111a110111111010111111101101100110011111111111111101111101112101110122020221220200201122202112221110001a
1111110011a0a1110101111111110111111111111111110110110010111a010001111110110101111110010111011111010110111101011111122221220121222111221212111212200121022121110b
1111111001a1a1111001111110011111101111011111111011101110011a010111111111110111111111111011111111101111011111111111221121122220101202202001221022022012210212210a
1111001111a1a1111001111111011111101111111111111101111111111a111111111111111111110011111101111011111011111111001110201220212221202122111112202222211222222222211b
1110111111a1a1111110110011111111011111101011011101101111110a011111110011011111011110111101111111111010110110011111110102212021100201120211000210222120201202212a
1110111110a1a0110111110101111101111111011011111111111110111a111110111111111001111011111111111011001100111111111111222011100211221112221212211212201022012122220b
1111111110a1a1111110111111111111101110011110111111111111110a111111111111110111001111111111101111111110111110111110201112212012122112202222221221211022211012222b
1111111010a1a1111101111111101011101111111111111111111111111a111010111011111011110110101101111111111101101111111111012121102101102121110011021022220112201110221a
1011111110a1a1101101101111111111111111110101010111010111111a110100111111111111111111101111111111100101111111111111112120021211111112221202202122112102211222221a
1110110110a1a1111111111100101111011101111111111110111110010a111111111111110101110111111111101111110001111111110101211111111211112220221122012011121101120122121a
0111011111a0a1101101001111011010011101011111101110010111111a011010011111111111101100110011101111111111110111101111012102212212212112111212211220201210222001202a
1011111101a1a1111001111111111111111110111111111111110111111a111111111111111111001101101010111111101110111111011111112120011122102122212022222122022122010202020b
0111110101a1a1011011111101111110111011101101111111111110111a111011110101011111111111111111101001111111011111111110010102200111220221222020200002221000111121102b
0111101101a1a1101111111111111101101101111110111111111111111a010110101100111101011011011011111101000100111100111011211102110111200221122122200022211011211121021b
1111111100a1a1110001110110011111101011110101110101111111011a111101011211112211011222011212112111200211111111111111111221111102221121222102222202221221022110111b
1110111111a1a1100110111111110111111110111111111111111111111a101111111222122221110212211221112001211211111111010011111011011111101011110002122222212112211221110a
0110111111a0a1010110010101111011111011111011110001011111111a111001110001211211210120011221210020021211111110111111111111111000111110111012112022001002102002212b
0110110111a0a1101001111010011100111010111111111100111111010a111101101101221122222222111211012102122201011111111111111101011111111111010111202202222211211211111a
0011111111a1a1111111111111111111111110111100111110111111110a111111111201112202202021211000122120122101111101111111101110111111111111111111222220210111212111110a
1111111111a1a1110111110111110111111100110111111111111101110a111111111212111210110111111220122212010211111011110101111110110110111111111011012011200112212201120a
1011111101a1a1111111110111010111011111010111111111111111111a110111111111122121022211112221121010222111101101111011101111111101111110111110221211222022112021221b
1111111000a1a0111110010011111111111110111111101101001111111a011101010001111121021121212122211212222211111101111111111110110101110101111111212202222201121220201b
aaaaaaaaaaa1a1111101010110111111111101111111011111110111111a111111111211222112121111200122011112122201111110101111111011101111111111011111012020201122121210211b
011111110111a1101111111001010111011110111110111101111001101a011111111221101110111002122102222010121211111112110122222211010222211111110212202121102002221121211b
111011101111a1111111111110111110111111101111111111111111100a111011011212011021012000101222021120221211111221111011202111110211111221021012110021121121020110222b
011111110011a0111111111111111110111001111111011010111111110a110011111222021212110221110121220120221211110121220111122022011221221022210010211121221122121112120a
101001101101a1111110111101101101101111101111111111110101111a1111101010210120111020212122212121221222110102210011200111212221111101222222122111002122111222121201
101011111101a1110111111101011011111101100101001111111101111a0101111112021220112212112121012011111210111011012000222211222222120210012211112221012121210022100111
111111101111a1000111101111111111111111111101111010111111011a1101011110121201022020101202222122212111111112201121212021011110212202202211022110202212202121222220
111011110111a1101101111111001111111110111111111111111111111a1111111010222201220222212111002021212012111112222102012221100122222101011120111201111121211112121212
011010111101a1101111111010110011110111111111111111101111111a0001011012111210021011112112211102211022101111120122102222120102122102101221101011001101101111111001
011110111111a1111111111111111110111111111111111110111111101a1111111110222112121121112222211112122021110112121222002112201001111212022012111111101111111111111111
100111101111a0111011111110111111010111111111111111111111111a0011011012111201200110012101021011211022111101221210120011012021021101112221011110111011101111011101
111001111111a1111111111111111111111101111010111111011110111a1101111112122212212001212020110011210101011011120221202222212020222110100022101111011011111111011111
111011101011a1001111011111011111110111110111011111011110101a0101010102211120121011112111000022202211111102121111211210221212111202022221011111111111111111111110
111111111101a1110111011111001110111111111011111111001011011a1110010110121012011221101221011102111211111110111112202022121122211121212201110110111111001001111111
110110110111a0011111011111111110010111010111111111111111001a0111111111212102111121212111212121211101111012111011001110211011211102221112110011111111100111111101
111111111111a0111110111111110110111111111111101011111111001a1111101110211202112111201220111220221110011011102122010011220001112020212112111111111110111111111111
110001101111a1110111111111111110011011111110111101110111001a1110111111120020121102101100122111211100111102221112101110010110011200101221110101111010011110100011
111111011110a1110111111111111111101101101111110111101111111a1111111111211221102001102111112201212202111111212111112111200111212111122202111011101111111011001101
110111010111a0111111111111101111111011111110111111101110010a0101101111211010102022211212110121222000111111222211221122211121101011222122111101101111111111111111
110111111111a1101111110111110111111110111101110100111111000a1101001112102202001111111220111122102221111112120220112121202002212211212022111111011111111111111101