61 16
129 104
116 85
152 6
72 92
59 75
137 31
3 48
63 99
17 49
aaaaaaaaaaaaaaaaaaaaaaaaaaaaaaaaaaaaaa1110101100011111011a111011101011101111110010011111111011111111111110111111111001011111111111111111101111112102121110121102
1111111110111111111110111111111111111a1111111111101111111a111111110110110110111111110111111111110111111111111111100111000011111111111110101211221122220010022222
0101111110111111010001111011100111111a1011111011111010111a111111111101000011111111110110111111010111100111101111111111111101111111110111121211112101122121012110
1111111011110100111111111111111011101a1111100101011111110a011111111110111111111011011110111111111101111110101010111101101111111111101111011212222210110221111112
1111111000111110011111111110111111111a1111111011011011111a101111011100111110111111110111111111111111111111111111111111101111011010101010011012111022211010211212
1101110111111111110111111111001111001a1110110011111011011a001110101111111111111111110111110011110111011110111111111111110111011111101101111211210020021111211001
1011111011111011110111111101111111111a1111111100111111111a110011111111011111011111101010111110111011111110110101111001001101110111011011122022222221100122101112
0111110101011110010011101011110111111a1111111011101111011a111111111101111111111111100111111011111101111110111110101011010111111111111111022022212222211022100012
0111111110100101111111101111101011011a0111111111110111110a110011111111101111110110110111110111111111111101111011101110101111101001011111121212210112210121210220
1111111111010111011011111111111111111a1111101111111011000a110111110111111111101110111001111111111111111111101110111110010110100110111111110202012221210022121022
1011110101111111111111111110011111111a0111101011111011111a110110011111111011110111111011111111010101110111111111111011011111111111111100110212021112211211021220
1111111101111111100010111101111111111a1111011111111111111a111111101101111111111011111101010111010011111110111110111101100101111011111111101112112012211112111020
1111111110111111111111101011010101111a1111101111101111111a111101100111011111111111101110111111011111101111111111111111011101111101111111121221112211202212120212
1110110011111011100001110110100110111a1111110110110111101a111111101111111111110111111101101111101111011111101011010111111110110110111011002222211222222222111111
1011111011101101111111111111110111111a1111111111111111111a111101101010111111110101111011111011110111111111111111111111111111111111111111121212022122102212101101
1011100110011101111111011111100101111a0111111111111101110a111101111111101111111111101100011101101111111111101011111111111111110111101110122221120012112202121110
1110100111111111110110111110111111110a1111011110111111111a111110111111111101111111111111101111111101111111101111110111111020220111001211122201220110201121211200
0110111111011110101111110111111111111a1101010101111110111a111110101011111101111111010011011111111110011111111011111111111102212121200212102122112122201121212221
1111111011100110111111101110111011101a1101111111111111110a111100111101001111111111101100100111111101101111111111110111011121211210020222222220111122112110112210
1111111111111111110011101101011011111a1000001011001111111a111111111101111011101110100111111011111111111111111111011110001110202201110210022222021220222121221010
1011100011110011111011111111110110111a1101101111011111111a101011111101110111111011110111110101011111111111101001101101111002101200111222202011202221220122221001
0111100111111111111111101111100100110a1111101111111111011a111111111111001111111111011110111010111111111110111111100111101112120111211212021001222112221222221101
1111111111111110111111110111011111011a1111110011110111111a111101111111011000111111111011101110111111101001111111111111111101102122222210122201220122221210111111
1111101101111111111111101110111111111a0110011101011101101a111101011110000110111111110011011111111110101011011111111111111111101021011201220200211022012021101110
1111111101111111111111111011101111111a1111110011111101111a100111111111110011111111001011111011111110111001111111111111011120122111112200111210010212221021101011
1101111101011110011111111111111111111a1111111111011111111a101111111011111011111011010110111111110100111111010011111011111122010112101121211102201111211111101000
1110011111001111110110010111101110111a1010111111101111111a101111110110111111110011100111100111111111111011111111111110110120211212002122122222221020222021111110
1011011111110110111111110111111111101a1001101111111101111a111100111111111010111111011111101111100110111011111111111010101112112112111122222212220212222101001111
1111111010111011100110111001111111111a1101111111111111111a011111111011011111110101101101111111111101011011111111101011111021221111121121122112220112220121111111
1111011001111111111111111111101111111a1111110111110101101a111111011011111011100101111101101101110110101111011111111111111111120122121101222222211121110221011111
0111011110011111101101111101110111110a0010101111111100101a101111110101111011111111101101111011001111111101100111111011001121110110222211102021121221112121101111
1011111111011011101110001011111111111a1111011111111111100a111001111101111111111111110111011110011111110111100111100111111111212020112100111110012022221110110111
0101111111101010001101111100111111110a1111111111111111111a011110111111110111001111011101111111011111111101111111101111010120201122010122112112111202011201010110
1011122111110022121111110111101100011a1111110111111110111a1101111001100111111101aaaaaaaaaaaaaaaaaaaaaaaaaaaaaaaaaaaaaaaaaaabaababbbaaabaabbbbbaabbbbaaaaaaaaaaaa
1002222102222022222211222021212001110a1011101010111111011a1111111110111101110111a1110111111011110011110110010110111111111021222021212220120012112222112221011011
1022212221222202221010112111100200111a0110111111111101111a0111101111111110111110a1011011111111101110111111111011110110111102021122121021112220012121222111111110
2122121222222221212220121222212201111a1111111111111111101a1110111111001011101001a1111110011111101111111100111100111111101120110020112212121022202202222111111111
2122222221011222121002111120212101111a1111111101111111011a1111010011111110111111a0111111101101111111011111110011111110111001222212121221211101220201011221111111
1120201222202112202112212121101020101a1101111101111000111a0110111011111111111110a1111111111111000011111111111001101111111110210001210010112220111210112221111111
1102220221202220222011202101012121111a1111111111011111111a1110111111111111111111a1110111111110111111010111111111011011110111212200021112201102211111122111111110
1022222221222222010210011212200111111a1101111111111101111a1111111011110111111001a1011011100111101111101011111011110101011111102110011112200001111112011111011101
2120111222020222222220202111110021001a1111111111011111011a1101111111001110110001a0010111111101111101111110111111111011101121112112201001112211110221022001111110
0220120221212222211022212112101121111a1010111111111111010a1111111111110011111111a1111110111111111111111111010111101111111112112200211121222122111012201021011111
2112220212220100212121202210211201101a0111111011110111111a1111111111011011111111a1111111011101000111111111111111111111111110020001201212111001012222021121111011
2201210022210222221212001202111120101a0111100111111101111a0111111111111110111011a0001111101111111111111011110111111111111122121010221220020111111010122221001011
0200202220222121122021120112112110111a1111011111111101111a1101110111101011110100a1110110111111101111111111011111111111001112212111100001211110121022120121111111
2022202221222222111022122222222221110a1111011111111111111a1010111101111101111011a0110101111111111110111110110111001111011120202222211211010012122220021201111111
1210122222200220121111111111211210101a1111110111110111011a1111000110111110011111a0111111111111101111111111110101111100110011101111010111111111101111010111101110
0222222222221122200021200111222211111a1111011111111111111a0011111001111111001101a1000011111101101010111111001101111100110001100001111101110110111111110111111110
1210002000200022202222212211111211111a1101111111101111100a1111111111101111111101a0101111110101110111111101111111110111101101101101100110111111110111111001011111
1122120210220122011112110221122211110a1111111111111111011a0100111110010101111011a0101111111101111011111111110011111111100111111111111111101101111111111111000110
0022022022212222022000020221121111011a1111111111111111011a1111110111111001110111a1111111111111101110111101111110111111111111111111110110111111111111111110111111
2122212200212112222120112021222120111a1101101111100101111a1011011111111111111111a1111111111111011101011111001111001011111111111110110011111111111110011100110111
1121010122200210012102120101122220111a0111111011111111101a1110110011111111111101a1100111111111011011010011100101001111111111111111111101111111011111101111111111
1222202122112212222121221011210121101a1110110100111101111a1011011111111111111111a1101111011101011001111111110111101111111110111011111110110110011111110111111111
2102212221200221221120112002221120111a1100101101111010111a1111110101110111110111a1101011110111011111111100111101111110101101111101111101111011110111111111111111
1222022000210221210220210221102211111a1111111111111111111a1111111111111111111101a1111010111110101101101011111101101011101101111111111011101111111001101100111111
2120212102020211122222220211211210011a1011111111011111100a1111111101111111101011a1111111101111111011010110111111011111001101111111111110111111111111111101011111
2120100222122122201112222022122120111a1111111110111101111a1000011110111011110101a1111110111100111111111111110111111011111000100011111011110111101111110101011001
2020002222122201221222201212122011101a1101111011111101011a1011110111111111101011a1111111110101011011101110111110010111110111111111111101011111111111101010111111
0202222122202212000102011110210110111aaaaaaaabababbbaaabbb1221221201122202211011a0010101111111111111101011101111111111101111111110111011101111110111101111111111
21221222102222101021101212121212111111111111021211211221122211221112120111210111a1111110101111010011011110011111100101111111111111111111101110111111111111101011
22112011222222222221210002212100200111011111010102111022222122012112212122011111a0110111111111111111100111110001001111011011111111111011111011101111111111101111
12220220122010222221111120220121201111111110211111211222120202102112002112111101a1011110101110010010101011001111111111101111110011011010011011111110010111111111
11112210001202212002011211212212210101011111211022002211001112021222221220111111a1111101011111110110111100111011110101111101111111111110011111101011111011111011
11100011110111101110110110111101111001111011122210121212122211212112112020211111a1111111111000111101110011110011111111101111101111111111111101111110111101111111
11111000110111110011111111101101101011010001102012211002210100121222021011011100a1101111111111110111111111111101111010111111111111111101111101001111101110111111
11101111011111111111111100111111111110110110201121221222221102022121122020211010a1101111111101111111000111010011011111011111111101111111101111111110111111111111
11111100110111111101111011101111011100111111211101021110211222221002112210111011a1110110001110111111111111000110110111111111011111111111111000011111111010101011
01111100011010110111111111111001111100111010022202002222221211111122201210110111a0101110111111010111111110111111101011111111111111111111111111100110110111101010
10011111010110111011111001100111110101101111121011112111221112011102111210111111a0111111101001111111101110111221120210100111200121211101110111111111111110111011
11111101111011111111110111111111111111011011110110210011112202121121122222211111a1110111001011011111111011201112121202022112100222121111111110011111011101110111
01111001111111010011111111011111111111111111122121010121112022011022201222210111a1111111000011111001112221221211201010010011212021121101011111110011110111111110
aaaaaaaaaaaaaaaaaaaaaaaaaaaaaaaaaaaaaaaaaaaabbababaaaaabbbbbaaaaabaabaababbaaaaaa11011111111111101111012221102222121221abaabbabbaabbaaaaaaaaaaaaaaaaaaaaaaaaaaaa
00110101111111111011101101011111101011110111102212021202022201121120220102201110101111110110111111001111111111121001122a002022111111111011111100001111111111110a
11010111111111100011111111001110111000111110121022120101102011220201121211111111111011111011110110111122110110212211201b022211002221111111011011000111100011110a
11001111111101110100000111101011111111111101201100120202120221111212022212011011111111111111000111011212220110212221211a012122112211101111110101101111110101101a
10100111101111111111111111111011111110110010212211102221002122120221022222221110211222100101111110111221002110120101112a101222102002110111111111111111111111110a
11111111011101101111111111111101111100011110212121002222112222220221001202221222111020021111100111011001211120111222110b112211112201011111111110111111011110111a
11101110111111110011110111011111111110111111111201102012212211222222222210122211212010011111111101110022002112101102211a211102212222111111011111010111111111111a
01111111111111111011111100101111111111111110202222100222121021001222121122220011212212200111110111101111021211022121120a221201211111111111101101111111011111110a
11011111111111010111010110111111100110111110112022110112101210222222221222221112112121121101111111011212220211121101122b101122211111010100101111111111111101111a
11101111111001110111111111111111100111011100000120221220122222201212222111111112210210101111001111101112122212112001022a021012111021011011101111110111011111010a
11111111101111111111111101101000111010101011112210110212220202122121022212202121221212111111111111111012121111222011211b122212120220101101111101111101111011111a
01100111111111111111111111111111111101111000112121211221221221200201112212222201020211121111111111111011110110112220110b120200020220111111111111110101111111110a
11110111111111111101011011011111111011011000200212222212121220222222222202120201202212211011100111110210011011222020022a212122222212111001111101101110111111101a
11101110111111110011101111111100111110110111121121022221120222121002222120221121222112021111111010111100101022120221021b121121121112110111111111111111011111011a
11110111111010111001011101111110110111111111120122222001100212222112012202221202112221211011111010101121202210221022110a220212121102111111011110100111101110111a
11100111011111110101011101110011111100111101021120222222022020221122202220222200000211221111111111110222221122211111110a200201111111000101111010111110111111110a
11111111101101101110011101011111111111111111012112202220022110220222212022210220101210221111110011011021111122121221201a222222222010111101001100100111011110111a
10111101100110010111111111111101111111111101202122222122222022221222222122220012222202100111111110101112211122121221112a022021211221111111111111110110011111111a
11101111111111101101101110111110111110111111111011122101202020102220222022222222120220121111111111101112020012112111210a210011101222100111111101110111001111101a
11110101111011110111110110101101111011010111111112201202022020220222222222022002201120021110111110111122222000101121221b211020120200011101111011011111111011101a
11111111111001111111001101111111111111111111111012222212122022112220220211202221111221211101111011011121121211222212011b212112110021001011111110111111111111111a
11111011111111111101001111111111110111101111101112222111122122222210102012010121112122211111100100101101221122121111212a0221102121111110111100110111001110111111
11111111111111101111011111111010111111111101111101210120222102022202202122212222211221210011011110111000212101212120222a2221222002101111110111111111101011011111
11111111111111111011100011111110111101110111111012112100122200000122222221122102210211121111011110011002110111010121112b0111101211011111111111111111111111111111
11111110101101111111111111111111111101111111111112111021220200220022022220122221aaaaabbaaaaaaaaaaaaaa121121222101001222b1210222012011111111110111111111111101111
11111111111111001011111111111111111110011111111111212221122212222222210202122220b1121022101111101101a110220112021121122a0222021001121101111111100101111111110111
11111111111111111110010101001111111101011101111110202121212222122202122222222222b2102020111001111111a202111102222202011b1201011121211101111011000111111111111111
00111111111111111111110111111001111010111011111022020221102102211022222212111121a2211220110001111011a021121122011011222a2100022210121110111110110111011111110110
11001111101111011100001111111101111111110111011111212222122201202222022002210221a2101111111010111111a111111111111011111a1111111111111111111111111101111101111111
11111111111111101111101111111111011111011111111102211022221022220012000121011102b2221111111111101111a111111111111111111a1111111001111111100001111111111111111100
11111110011110011111110111111111100011101111111111212111022201122220221200120210a2222202111111100111a111111011101111011a1110110111111111011111111111111111111101
01110111111110011111111111111111111101101111100112121122220220012021202222121201a1122012101111011111a111111111111110111a0011101111111111101111101110110111011111
11111111111111011110101011101101110110011011001111101221211101221122212200201220b1121212110111111111a101111111110111111a1111111011100101111010011111111011111111
01111111011111111111111110111111110011111010111022111222121212121221022200222110b2121112111111010110a111111100111111100a1111111111110011100111111111011111011111
11110101011111100111010111111111111110111111111111101221200221222200122220112122b2211222001111111111a111010111111101111a1111111110110110011111111111111101111010
11111111010110111111111111111111110001111111111122222201022210211201101222210220a0111010111111111111a101111111111110111a1111111111111111111100011111111111111111
11011101111111111101011111011110111011111011110112220122021210220201211100111211a0111110111111111111a111101111101111110a0100111111111111011111111111011111011111
11111110111000110100101110101011111111111101011011210221112112202222212111211110a1101111111100101000a011111110110011111a1101111100111001111111111111101001111101
01110111011101111111011111111110111111111011011110011222112102122100012122121110a1111100100101100111a011101111111011101a1111011111101101111111111101110110001111
10111111111011111111111110111111111101111111011100122121111201100011121202221120a1111011011111111110a101111111111110101a1111110111101111111101011111011011011110
01111111011111011111101110011111111111011111111121212121122221020020120211211110a0111111110111111111a011111111111111010a0001111111111111111111101101101111111101
01111111011111111110111011111010111111010100111101221101222122211222102120222221a1101011101111010010a011001111101111111a0111011110111011111101111011111111011101
11110001001111111111110110010111111111100010111111111111111111111110111101111111a1101111111101101111a111110111111011111a1111001111111101101110111001111111111111
01111111111110101111101111111111011110011100111111111110111001010011111111101000a1111111011110111011a110111111111111111a0111001101111110111111100111011111111100
aaaaaaaaaaaaaaaaaaaaaaaaaaaaaaaaaaaaaaaaaaaaaaaaaaaaaaaaaaaaaaaaaaaaaaaaaaaaaaaaa1011111010011111001a111110111111111011a0111101111101111111011110100011111111110
1110101111110011100110100101111111111111011111011111111011111111011101000110111101010110111100111111a111011111101110111a0111111111111110111111001000111111101111
1111110101110111111111111111101110111111100111111111101111111011101111111111111110111110011111111110a111011100110111111a1110011111111111010111111111111111011100