0 55
113 5
6 9
37 74
21 23
140 6
159 54
8 103
12 42
57 119
122200212112121101201100101110111100110101111110111111011101110101010011101111111000111111111011101111111a110111110010101110a0122211211112012202abbaabbaababaaaa
222121112121222211202211111011101111111111100110110111111111011011111111010111110110111011111100101011100a111111110011101111a2121020111211210112a021222111121001
121122012221222201121011111101111011011110111111110110110111110010111111011100001111111111101111101111111a110111110111011111a1022222221122210110a111222101011101
122021220101002211222201110111111110111111011111110111101011111111111111101111011111111111001111110111011a001111001111111111a1201122112211022122b112010020111101
222111221120020211200111111111111100111111011111101111111111111111111101011011101111101111110111111111111a111111111000111101a2111021102021021222b202122011111010
221222211222222212222110111101111111111111111010110101111011111011101001111111110111111111111011011111111a110011111100100111a1221221121121122221a120022121200111
212021201220212222222011111111111111100111111111110101110110001110111111011101110111110111010110111011111a101001101011111111a2202212011012021121a010112212201110
210121111110222021111201110110100111111110110111111100111011111101111111111111111111110110101101111111110a111111110011101110a1121111101122211021a221102222121111
110121221010212222222212021100200222211111111111011111111111011111111011111111011111011111111110111110010a101111110010111101a0011221210000120222b221212220101101
121121212222202020111112102111210112101111111111111110011110111111011111011011011110110111110011110111110a111110111111111111a0112220112122201120a122222201201101
111212110221222202222222212011211212001111111011011111011101111111011011101111111111111101101111110011111a100111111000111111a2221021220012111111a202201121111111
222120001111110020212221012222202112210111011111111011111011111110111111110110001101110111011101011111111a110101110011111110a2021212112112211112b222021000111111
211111222222122011221211110221102221111111111111101101111100110110010010111111101011010101101111111111111a100011111111110111a1110011012122210001b122001121221100
221122220202122210202212012220110210001110111111110111101111011101111110001111011001011110000101110111101a111111111111111011a2220102202202222112b202212111100111
212021122122102012112222211110222121111111110110110011110001011111011101111110111101111011111111111111110a011111011111011110a2221211220002111220a122000221211111
111101102212022111212221201122120112001011110110011011011011111011010001011010111110101110111100111111111a110110110111011111a1121121020112210200b020221211111110
120111222222221221122211212222202221001110101010101111111111111110101111010111111111011101111011111111111a100111111111111011a2202102201111111120b221112121101001
100211000022221212122221221120111022111111011100111011111001110100110010111111011110110101011110111111111a011101111111101110a0212111220220201101a212111111121101
002022112022212112122222111201101122111110111111110110111110111110001111111001101111111101111011100101101a111011001111111101a2220111220222220122b102212111121011
000212222220122010202222110220222202111011111010111101111111111111101101110101111011101111111101111011111a111011100101100110a1121121122111121102b120111212221111
121210221222202222010211112202112022110111101111110101011001110111111010011111111101111110111111111010101a111111111111110101a1112101111212012112b111102200200110
012122202201222112222221002121202021111101111101011111111111110101111101101111111111111111111111110101111a111111011011111011a2222111211220211121a211120220101111
112100122121221201222211020202212122110111011101111111011111111111111111110111111101111111101111110111111a111101110011111010a1101011110111111111a111101111011011
211202112222222221101102210102210120111011110111011110111111001110111111011111111000111100101111011010111a011011011110100011a1111111111111110111a111111111111111
121012122212110021222111122120121100210111111111111111111111111111110111111011111011101111111110111100101a111111110001001011a1110011110111111101a101111111111001
111101021111010220210222121122201221211011111011110111111111011111111111011111110111101110111111111111111a101111001111000101a1111111101110111111a110111111111011
111101212122221122002222121222011221101111111111111111111001101111111111111111110001011101111100111011111a111111011011111101a0110111101111111111a010111111111110
110220221222002022220220122111222112011101111110011111010111010111101101111110111111111100111111010111001a111111011011111110a1111111111111000111a111111111111111
212021222121022122122222102211111220211111111111111001110111111111110111111011111111111111111111101101111a111111011110101011a1001101011111101101a111110011111111
111011200222222202111220212221112221211101111111111011110011011110011111111111101111111111111101110111111a110110111011010111a1000111001111110110a111010110111111
011100122221022221002221000111022120111110101111100111001101111011111110001111111111101111010011110110111a111111011111111011a0110111111101111110a111111001111111
122021220022022022222222221200201120111111110111010010110010111011011111110101111111110011111100101010111a000111111111001111a1111111111111111110a111111111111111
121221102212112222122212222211001111211111111010110011111100111101100111111111111001111111110111011111111a111111111111100001a1100101000111111111a111000011111101
212022221222221202222122222222112021011111111010111111011111111111111011000111111001011101111111111101111a111101111111111111a1111111011111011110a111011111111001
aabaabbbbabbbbbbbbbabababbabaaaaaababaaaaaaaaaaaaaaaaaaaaaaaaaaaaaaaaaaaaaaaaaaaaaaaaaaaaaaaaaaaaaaaa1101a100111110111010100a1111111111111111111a111111011111110
2222202220212021122220212202221001110111100101110110111011011101111101011111111111111111111110011101a1111a111111111101111101a0101111111110110001a111010100011111
1121122202001102222011202022010120220101101111111111101111111110011111111101111011111011111111111111a0111a111111110011111111a1001111111111111110a111111111111111
1111121101222222222022221222122220222110001011011101110010111011111011111101011111111111110111111111a0011a111101111111101111a1101111011111010010a111111111111111
2212222021222011222222222222121112210011101011111100111110010100111101111111111111111111111100101111a1111a111101001101111011a1111111101010111111a111111110101111
0121112002112111222101011210101101101101000111100110000101111011111111110111111101111111111111101011a1111a111111111101110111a1111111111111101110a101120221112011
2222101020011201110210111022111011101111110101100001111011111111110111111001101111110110101100101001a1111a111101111111111110a1110101101010001101a212122120112200
1211112120112221001021121212100111111101010111111111111001101111101110010110001101111110111111111111a1110a101111101111111011a0111111011111111111a222120002111102
0101220121111112212220112011100111111110110111111111111111111011111111101111111101111111100111111111a1010a111110101001101111a0101011011101111111a202222110012111
2012211110110112011220121202110111110111111111101111110101101011111111111111110111011100101111111101a0011a010111111111000111a0011111111011111111a222202012000222
2112110112111122121220122112101111111111101111101111111101111110101111101101011111111111111111111111a1101a111100011111111111a1011011111111001111b202211210222121
2111111110210121120220002211011111111101001100010110011111111111111010111111011010111110000111001101a1101a101111110111011011a1101101111101101101a121112212121121
0102212201121111222120222122111010111111111111111110111111110111101111011110111001111101101111011111a0111a110111111111001101a1011111111110011001b120202111111221
2102222211221121201211122010111110111011111011011111011111111111111110111101110111111111110111111111a1101a111111111100111011a0111110111011111010b112112102120021
1201021101001111012002220202101111111111010111001111100111100011111011110111011111111011111110111011a1110a101011111110001111a1101110101110101011a221120012210120
1120122111020210200222122012011111111111101111001111111111111111111011011111100111101100111001111100a0110a111111111011110101a1111111111011100111b121122221212221
1101022020222221111211101122111001011101111111011111111011011111111010111010011111111111111011111011a1110a111111111101111111a0110111111101111110b211012101110110
2021221011212112211022200110011111111111111111111011111101011111100011110111111111111110100110011111a1111a011001111111011111a1111111011111110101a212112212012212
2202112002110112022221122021111111111111101110111001111111111110111111111111101110111011111111011001a1011a001101111001111011a1100111011101011110b201212110201012
0122220200112121101022222202111101111111101111111111101111111111111111111010111111011111101111111111a1111a111111111101111001a1011101111111100101a120011222002221
2221011022212111021221221101111010011011111111111111111111011111011101111101011111101110001111011111a1011a100111111111111111a1011111110111001111a102202221122110
1020222221222111121221220121101101101111110111111111111111111111111011111110100100101110111111101111a0111a111111111111111111a1110111111101110011b121111100022110
2212121112202110222002102100111111111111101111111111111111010110110100011010111010111101111010111001a1111a111011111111110111a1011111011011111001b011101121012211
1010102222112121120212211002111100110000111110111111101011111111101111001110011011111111101111111110a0001a111111011011111111a1111011111111111101b222121221100111
1101111001111111111010111111011011111000111111011110111101101111111111110101111111101111111111101111a1110a111110101111111111a1111111101101110110b122001211021002
110111111110aaaaaaaaaaababaaabbaaabababbabaaaaaabbbab11111111111111111111111101011110010011110011111a1111a100111111111111011a1111110111011101110b121212220212022
111101111111a111111111012121102012220220022120201222b11110111111101111111111111011011111111111110111a1111a111111111101111111aaaaaaaaaaaaaaaaaaaaa222111222211222
011110111110a101111001222222201011220222010221210011a01111111001101111011101100111011111111011111111a1111a110111011111100111111110100111011111001122222112210212
111111111111a111101111011212210211222101111200112222b11111101101011010100101111011100111111111101101a1101a011111111101011111101111111111001111100120211221202121
011111111111a111111011112010101222112222202020122212a11101101100110111101111110111011111001110111110a1111a111011111100101111101111011011111110110121222021011002
111111111111a001111111022211222201202222211210210021b11111111110111001101111111110110011001111110111a1111a111011101110101100110111110011111111101220122221121220
110111110111a101011011221011021001212222010012222202b11111111111010101111111111101011111111011111011a1110a111111011101111111101111111011111111111100011221112122
111111011111a101101011022022222201100221021111112110b10110111101010111111110111111011101111111111111a1101a101111111110110011011111111111101111111212211111002211
110111110111a111111101111001120212110022221222212121b11101100110110110111111111011111111001101100010a1111a001111110111111111110101101101101100112021222202221000
110111001111a111111101222121022120200201200112011120a11111011111111111111111111101011110111111111011a1111a111111101111111111111111011111110111112111110211222221
111111101111a100111111112111212210221002222001211122b11111101111110111111111010111111111111111011111a1101a110111111111101101110111101110111111111101211112011222
110011111111a010011111011011110211021210121211201202b11111111111110101011111111110101111010111111001a1110a111011001111110101111111111111111010111101111101010111
011111111111a111110110110021212110022212120012021102b11010111111101111111111010101011111011111111111a1111a101101011111111101111011111111101111110111111110011111
111011111101a110111111000211102112212221000122221222b11110111111111000110111111110101111111011111111a1111a111111111100111110110111110101111111111101111111101111
111101111111a010111110221222212220120120122100111202b11001011111111111111101100110011111111111111111a1110a111011111101111110111011111011110101111111111011111111
111111111111a111101110122002221212210021110202221011a11010011011010011011110111111101010111110111110a1100a111111111011101111111010111111101111110111111111011011
111011111011a011111000220201010021021222221122011100a11111111110110011101111110110111010111101111111a0111a111110011111111110111111100101111101111100111110111111
101111101111a010111011011120212222121111011120211221b11101111111111111011011111111111111101110011001a1111a110111111101010111111111111111111111111011111011011111
110001101111a111111110102220121121121110111101121121b11111111011101010111111001111111110111111111111a1111a111111111111011111110101111111011111111111111111110111
110101111111a000111011211121222012121221202112011122a11111101110111111111111111101011101111110000111a1011a011001111110110111111111011111101111111111011011111100
111011110101a111101001222202021012221210120100120212a11111101000110111111111111111101111100110011000a0111a111101111111101111011110111010101111111101011111111011
101111011111a101111111211111220211021222222221121212a11111111111111110111111110111101110111111111110a1111a111001111111111111010111111110101111110101111111111111
011110111100a111011111102210221121100201021221210012b10111101011011011110110111110011100101101101111a1111a111111111011101101111101100111101010111111111111111110
111100011111a111111001221101122222011122122121111110a01111101111111111100111111011110110111111010111a1111a100101111111011101111111111110111110101111111100111111
011110111111a110110110211211111020112022011212012201b01011011110011111101101011011111111111111110111a0111a101111111111111111101111011100011111010101011101111111
001111111111a111111101001102112222112110101122121201a11111101111111111010111111101010110011101110011a1111a111111111111111111110110010110000111011110111111111111
101110111111a110000100111122012222101021001121120102b11101111011111111101111111111001111000111110111a0101a111111111111111111011111111111001110111001110010111110
111111110111a111111011021112201112121200121222220001b10111101111111111101111111111111000110111111111a1011a100011111111111010111111111111011011111111101111111101
111111111111a101101111201211210021212211112022221211a01111111111111011101010111111011011011010001101a1011a111011111111101101111110011111101111010100110101111111
201122201122a021111010221002011112200211221111011121b11111100110111111011101011111111111111111111111a1101a110011011101111100111101101111101101111111111100011110
221121211212b212021212221111022110212100221111222202a10011011110011111111111111111111111110110111111a1110a111111011110111101111111110111010111011101000001111111
211201202221b112112122110111111011111011110111110110a11110111101011011111111111110110111111111111011a0111a111110111111111110111111001111101011001111011111101111
110122111220a212212221221100111111001101111011111111a11011101110111111101111111111101110011111101011a1111a110100111101111101110111111111111101011111111011111000
011222120222b122122212211111110111101101010111011011a01111111110110111111111111101111111010111111111a1111a111111010111100101111111111111111111111010011111111111
120021212220a210122020111111111111110011111111111111a10111101111100101111110101111110111101100011100a1100a111111111111011111111111110111101110011101011111111111
211020022202b212121212221110111000001000111111101011a01110111000111111111011011011101101110011111110a0111a011111110111111111101111110111101100111111111011111111
201221220112b112221211011010111111111111111111111111a11111011110111101111111111011111110111110101111a0111a011001110010011111111011101111111111111011111101111011
220112022201a212022121211111101110111111101111110110a11111011011111111111111111111111011011111111111a1011a110101011111111110110101100111011111111110111111101110
221220112101b121011222011111111111011010110111111101a11101001111111110100011111000100111111111111101a1111a111101101101001110111101111111111101111101101101111111
120112110121a112022221011111110111111111110011111111a11101111101011010110110101111110011011101011111a1111a101111001111101110110110111101111111111110010010110001
110200222120aabbaabbaaabaaaaaaaaa1111011111111001110a01101001101111110111111011011101001111111111011a0111a101111111111011111111001100101111111101111111011111111
21102211201211221110001011000110a1111111111011111111a11111101100110111101011110111111110100001111011a1011aaaaaaaaaaaaaaaaaaaaaaaaaaaaaaaaaaaaaaaaaaaaaaaaaaaaaaa
12212122111221211211121111111111a0111111111101111111a11111111101101111110101101010011110110110101111a01011111110111111111111111111001111110110111111011100111111
02221211111122112120111111101011a1111111111111011111a10010011010011111111111111110101110101110111111a11111011110111110111111111110111111111101111101111111111111
02111112210121110011202001100111a1001100011100100111a10111101101111101111111101101011101110111111111a11111111101111111111111111111111101111101111111011111111011
21111111022112111222212211111111a1110111111222121212b00202111222212202121111101111111111011111111111a11111111101111101111110111111111111111110111111010110111111
10111200111021212112211210111101a0011111011222021122b11012201120221202211111111101111111111111111111a11101001110111001111101111111000111111111101110111111101111
00211110221221200112212111111110a1110101112210122122a11202121102202022222110111111110010111111111101a01101111111111011110111010110111111011111110111111110011101
12112002111022010200212111111001a1111111001112112121b21122201211122110222110111110110101011111111101a11001111110101011010111110111111101100111111111101111111111
22221212212122202221121211110111a1001111110222000221b22110011102112120220110111011111011110111111111a10100101011111111110111111001011001110111111111111111110110
00112211212012200112101111011111a1111111112101200122a02211122022112111020101111101111111011001101011a11111111111111101011111011111111111100111011111010101111011
22012211021221010112122110010111a1111000111011111211a12201020112112102221111111110111111111111010111a11111110101100111111111101110011110111111111111101111111111
21211110121022221122221001101011a0010111011222101012a12112210201221211212111101111101010010111110011a11110111110111101111011011110101111111111101101111011111111
10212111112122111201111211111111a1111111111212011211b21110201021221102110101100001111111111111101111a11111111111110111101111111110101111111111111111101111011011
11201101211201121220121101011111a1111111010212101222b22011201120210212211110101111001110111111110111a10111110001111111111111111100111111011011001111111111111111
22222220121112102112212111111100a1101111101122210120b22120122221201121221001111111110100111111111010a11111011011011111111110111101101011111111000101111110110111
22112122110011200120121211111101a1011011110012011112a12001110201110000002101010111101011111111111110a11111110110111111111111011111011111111111111010111011111011
12020121220012212021111111111111a0011010112222212121b10221112201222121111111111111110110011011111101a11101111111111100111111111111101111111111111111111111111111
11221022212122010121222011001111a1110111101022221122b01221220021222221122111101011111111111110111111a11111111111111111111101111111111111111000101101111111110110
12122222110021211101112001110101a1101100100212111121b22111220222111012120110111111110111111101111110a11111111011111111110010111011111110111110110011111111011111
11111111110110111111110111011111a1111110011110222100a12210220211222210201111111111100111101111101111a01101111011110110111110111110111111111111110101110111001001