145 107
14 0
18 89
128 20
78 19
103 45
96 103
59 102
98 97
70 86
1100111011110111111111010101a1011101011111111101011a111111111111011110111111011011100110110111111111111110110110110111111111111101111111111111111100111111a1111a
1111111011101111110100111111a1111100111111110111101a110011011111111111111111011010101101111111101111110110111111101111001111111111111011111001101111101001a1101a
1111010111111011011111111011a1111111111011100011111a011111100111111101101111111111111111111010111111111011011100111111011110110110011111011111111011110111a1101a
1010111011111111111110111001a1111011011101111011101a111110101101101111101111110111111111111111111001110111110111101111110111111110111011111111011110011111a1111a
1011111111111110111111111111a1111111111111111010111a111111111112221112120222121202212202110200110111011111010010111101111111101101110101101110110101111111a1111a
1111110101111110101111111001a1011010111111111011111a111111110111010222111101112122222111022112011111011100111101110211011022110110201102101021111100011010a1111a
0110011111111010111111101111a0111001111111111111011a111111110112112022202210210200222111210020111111011111011111111202021021110111122120012221221101010101a0111a
1011111111111111111111111111a1011111011011111111111a111001110112021122211111021102201210111102011110111111111111112111102211210121112021120102221000111001a1110a
1101011111110111111101100110a1011111101111111011111a000111110111201121122221000211222022000122111011011011011111112112011111222220120101210111111111111111a1111a
0111101101111111111110111111a0011111111111100111101a100111111112111221202121212022212010121212111110111010100110111121112202211212122222112220220111111111a1111a
1111011111111110111011101011a1110110001111011111111a111111110111111221021021201221110020200112100010001110111110111221011012212022010111202111210111101011a1011a
1111111111111111100101111110a1101111111101111011001a111111101110222220122201202211112100022002111111001110011111102111111201212110100120210002121101011111a0111a
1111011110111110111111011110a1111110101111111111111a111111111101120211222020022201212002111101011111111111110111012121102202112210210110201020011111001011a0111a
1011111011111110111011110100a1110111101011011101101a111111110112212201120222222122211022210110011101111011110111101211221221122101211002222222111111101110a0111a
1111101111111011110111111111a1110111111011111111101a110000100010122002021122110121110112012220111111110111011011011100211212200121111202101011020111100011a1011a
1110010011101011111111111101a1011111111111111111111a010111010111121011201101112212202010110220011111111110011100112101220121222020121101112111201111110111a1011a
1100111110111101001000011111a1101110100011111111111a111111111012221122011212211202002011020021111111011111111111110202112121211102212112110111121111110011a1111a
1011111111111111110111011111a0111110111110111001111a101010111010011210222111111022101012111211101111111111111111101111222220110020222112100212121110111111a0111a
0011110011101101111011111110a1110111111011111111111a101111111112112001121212112121001211212121101110111101111111120220102220212212121020011111210011100101a1110a
0111101111110011111111010111a1111111111101111001111a110111111101222111012021210111101222201222111111111111111111121121012210120102001220221211021101110101a1111a
1101111100111111011101111110a0110011101110111110111a10aaaaaaaaaaabaaabaaababbbaabbbabbbbbaabbaaaaaaaaaaaaaaaaaaaaaa121011122121101210212112221211111110111a1011a
1110111111010111101110101111a0101111010111111111111a11a01111111112222202211121100111201211021111110011111111111011a111112212002212120122111122111110111010a1111a
1111111111100011110110110111a1111110111001111111011a11a01111111121211220110222100212210212101111111011110111111011a122121111112112212122222222011111011111a1111a
1111010111111101111110111111a1101111111111111111110a11a10111111102212211002111101010012201000101111101011111001112a112120121021121212122112112211001111101a1111a
1111011111111111011111111111a1001010011111111011011a11a11111111101021022200101222220102112102201111010110110010112b222022211222221102112102110021111111110a1110a
1110101110111111001110010101a1010110001111111111111a11a11111111021120011100220020101121220001111010011110110110001a120002222102222221122122011221111111111a1101a
0011101111111111111101011011a1111111111111011100010a11a00111111021021112020011102111211211212111111111101111111111b012121222211020121222001212221110110011a1001a
0101100111001001111111000111a1011101011011111010110a11a11110111121202221111201220111220221102210101110110111111112b210121211212111102020010212120101110101a1111a
1111111111011111110011111111a1111111110111111011101a11a11111011210121202201021112111222212222010111111101111111112a102111222212212121222201022121011010111a1100a
1110111110101111110111111111a1111111111011111111111a11a11111101010112120110111122121111010222111111111111111110111a102112201022212012012122121111111111111a1101a
1110111111111010011111111111a0110111101111111101111a01a10100111222111211220201111111021121112211221111212221200211b212221112002012112110101002211010110101a1110a
1011111111011011101111111011a1110111101111101110111a11a01110101211110001202212201112020212202011121002221111220012b211011211101212222202112221121111110111a0111a
1100111111111111101001111101a1100001110011111111011a11a00111110020112212121201112201102222222212111020010121202101b221121010121212200121022221011111110111a1111a
0101111110110111101111100111a0111011111111101111111a11a01011111222101111111012002111112110222211021002112211122200b002220210111212122212212212101011111111a1100a
1011111010001110111111111011a1011111111101111111110a11a11110111220210112211102222222122112202222000122101101212112a222222101210211201222212211221111110011a0111a
0011101111111001111111100101a1111110111111101111110a11a00111111010111111110111110111111122111212212011111112220112a212021201022022012010002011221101011111a0111a
1101111111011101101110011111a0011111111110111011011a11a11111111111111101111111111110101122101111122112110212122102b100101101111111111111101101001111111111a1101a
1111111111111111111111011111a1010110110111011111110a00a11101110010011011011011110101111120210020221211221212222112b211011111111101101011111110101111111001a1111a
1101111111111001111101111111a1111111111011110011111a11a11111111111101111111111011110111012110222012220121202022122b111211101111011111110111011111110111011a1111a
1111111111111111010101011011a1111101111111111111111a01a11111111111110111111011100011011011101112102001121210011221b020201111001101111101111111110111111111a1000a
1011111101111111101111101001a1111110111111111111111a11a11111110011110111101101101101111110110020221102111222100111bbabbaaaaaaaaaaaaaaaaaaaaaaaaaaaaaaaaaaaa1111a
1111011111110111111101111100a1101111111010111111110a11a11101011111111111111111110011101112212111211200201122121222001021101111010010011111111111110111111111111a
1111101011111011011011111101a0111111101011111110101a11a11111110001111011111011110010111122101111012111010012110221210221111111011111111111101001011011111011101a
0111111111110110011110111111a1111011111001101111111a01a11011011111111111111101101100111100121210100221211020220211201111100011001110110010010110011111111011111a
1111011010111110111010111111a1111111100111111111111a11a11011011001110111001111111111001122110101002221112122202121212201111111011111010111111111110100111110111a
1011011101111101111111011111a0011111111111110111111a11a11101101110111111111111011010111102001120122112110111002112101121111111001011111111111111101111010111111a
1001111111110111111011011110a0111011111101111011111a11a11011111101110111111110011111101112012212122001211022212122021121111111101111111111111111011111111111101a
1111111101111111110111110101a1111010000111111101111a11a11111010011001111111101101111011112222122101121212002221122112101111110101111011111111111111011111101110a
1111101111111110111111111011a0111001111110110111111a11a11111100110011001111111111111110020122211212121211222001022211111011111111111111111110101111111111111101a
1111111101111110010111111111a1110111111111011111011a11a11111110101100111110111111101011122212022011110221222120121220220111111111111111110111110011000101111101a
1111111111111110110111011100a1100111101101011111101a01a11111111111111111100110111111111101211101211221122110202120112221010111111111111110100101010111011101111a
0111111101011101111011010011a0110111111111011111111a11a11110011111111111100111110110111122112201222112212201111112010011111001111111110111111111110101110101111a
1111001111011111001111111111a1110111111111111111010a11a01111111101010101111101011101100121221012100210221120122111210110110111010011101111011011111111011110111a
1111111011000110100110101111a1110011111111011010110a11a01111011111111111111101110111111120020211220122110202002112211211101001111111101101111011111100111111110a
0101111111111010111110101101a1111111111011111111111a11a11110111011001111111011111111111121220000112020012211201212101221111000111111111110111111110111101110011a
0111111100111111110111110110a1100011111101100111111a11a10111110111110101111111111111101120011010002110121120210001202211011111010011101111111111110101111111111a
1101111000111111111111110111a1111111111111011110101a11a11101100111011111001111111111111121111211222001101102012121210121110110101111111111111010111111111111101a
0111111111111111111111111111a1111111101111011111010a11a10110101010111111111101111101111102012112002222221212221221112201111111011111111111101011111111110011110a
1110111110111010111111110111a1111111010111110100111a01a11111111111111011101101000101101012121020012110011222112011220211111011011111110111101111111111111111111a
1111111111101001111011101110a1111111111111101111100a11a11011011111111010110111111111100121111222112021100211210210220110111111001101111111111011001111111100111a
1111111111111110101011111010a0101110110011111101111a00a11111011111011111101111101111111111101221221220212211001021220211111111101111110111101111011111011111111a
1010101101110111101111111111a1111111111101111111111a11a10111111111011111111111011111111111110111110111001110110111111010011110111001010111111110011010111111110a
1110101111101110001111111011a1011110111111111111011a10a10111111011011100101101111111111110111110111111111111111110111110111111111111111011111111101111110111111a
1111111011111110110111111010a1111111011111111111110a11a11101111101101111110101111101011011111111111101111111111101010011110010110111011011110101111010111111011a
1111110111111111111110111011a1111011110111101101011a11a11101011111110101101001111111010100101111111111101110110111001111111111111111111111111111111111011111111a
1011101011011101001111110111a1111100111011111110111a11a11000011011111111101111111111111111111111111011001111011101110111111111110111010111011110101011111011111a
1111101111011101011111110110a1111111111111111111011a11a11101011111110111111111100101111101101110111101111111101101100111011111111111111111100100111010111100011a
0100011111110111011101110111a1111100001111111110111a01a11111111111111101110011110101101111101111110110111111000111011100011111011111101111111111111101101011110a
0111111111110100111010101011a1101011101111111110111a11a11011001111111111101111111111101110111111110110110111010111111101101110101111111111011110111101110011111a
1111101011111011100110111111a1111111101101111000111a11a11011111111101111101111001111011101101110111111111111011111011111111111111110111110111001101001111111111a
1111111101001111111101111111a1011101101011011111111a11a11100010101111111101111100111010001111111011111111111110010111111111111111011110111111111110111000100111a
1110111011111111100011111110a0111111101011111011011a11a02102121122212112020212110122020111111110111111111111111111001111111111011011111011001111111101111011000a
0111101101110101111111111111a0011111011111111001110a10a12111111212002012211211021210211111111110111011111101111111101111101111011010011111011111011010110111101a
1111111101101011111111111111a1111111110111011111111a11a11220120012011211212102221012021011111011110111110111110111111111111111111111101111110110111101111110111a
1111221021221202221021002011a2121010101011011111111a01a12222221200011121221011111112021101111111110011101111111111111111011101100111111111111111111011000001111a
1111122111012102110112012221b1222110111001111111011a11a02111222121110002212122221210011011111111111111111001111110111111101111111010011011011101111000111011111a
1110110221202221222102221112a1212001111111111111011a11a20221112210221112022020220121101110101111011111111111010101110111101010111100111111111111110111111111110a
0110021012010022012122110111b0211111111111111111111a01a21212011102022101112121021201211111111011111111101111011110110011110011001111101111101111111101011111101a
1111112211222011112102221201a2201211001111111111111a01a21122202121110221221012220111020111111111111101111110101101111110111110110110011101011111110111111000111a
1112210102212212221122212211a2200010101111110010001a11a12220101021221021111121011210021111011111111111111101111111011111111111111101110111111110111110100110110a
0110221212221210211101112021a0012111111011111010011a11ababbbababbbbaaaaabbb210112211210111011011111101110111111111011111111101111111111001101011100110111111111a
1102221002120220111122201202a1121100111110101111011a1112111211212210121101b122111212221111110010111111111101111011111111011111111111111111110011111111111111111a
0110010121120111111112211211a2020201110111110111111a1102022222220221020221a120211222202112121200211110112112012200111110111111111111110001111010110111111101111a
1112111110211220212111111011b2100110111001111111010a1112201202200122021222b222121222121022221102010012211212111210011111101101110111111110111101111111111111101a
1111011222122210020121011221b1121211011111111011111a1110000212211021222020b212211112121222121202021202221122022212111111111001111111111111101101111101111111101a
1112211222222122222110110211a2201000111100111110111a1111212212111002112211a200221012122121020120000222221220212012111110111110111001111111111001101010111111110a
0110112111122212200122202012a0201210101111111111011a1101210121211010121221a101021222210010200111210012211112211022101100111110001111111111001111101101111110111a
0111220221210202100001122112a1110211110110112121220a1102222212220001110112b101022222022012121122000102002111122202110101111111011111111111111110111111110111111a
0101201212221120222112222111a1012111111111010102022b1212220220202112012220b011211020222221122222201210112202221201111111111111111101111111111111111011111011001a
0110121102200102222212102202b2121211101111111110111b2202122200112222120121a110202220122222222212222022222222112212111111111111110111111111111101111111111111010a
0110212220202002211202221121a0022200111111112111012a0120122212220222022211a122102220222210220022222200212122222211101111110111111111011111110011111111111111111a
1111201011101210222222102012b0122111111111112121100a2110212120222121221022b221011202201221110221222022221112202202101111110111111111111010111111111111110111111a
1112111122100111222021121102a2211101100111102201212a2212202102222222121121b121210202122201222212202022222120222210010111110011111111111101111111110011111111110a
1112122121210212121221211112b1102211011110012121102b1212102221022022112201b020021222112100211120222222220020211101111100111100111011111111111100010111111100110a
1112212120111212111210111000a2112211111111110110221a2212210122122101202122b211110022002202202201012211222212022220111111111011111011111110101111111111011111101a
1011011211112111211211122201b0121211111111010122112a1202122010222220012210b101101210222221222122220202220121201021110110111011111111111101111111111100111111111a
1111221001022210112102111210b0102211101111111221222b2122122021212221102212b111211022220002212222021222120111222201111110111110110100111010101111111111111101011a
1112200211211220120221021221a1101001111111111111211b2001002222221222022022b102200220221222222222222222202021222021111101111010111010110110111110111101110111111a
1011010101202110201101122101a2201111111111111210020a2112021201112220212222b122111222202220122220212222222200022221101110111111110000111001110100111011001111111a
1112122201221111022221201201a1112111010001011221210b1212211020221212222122b222011222122221122122212222122200100222111111111101110111111111111101101111111111111a
1010022222121012211202122122b2221101111101111210120a1102102212122121102221b110222202222212202222212202222102022022111111111101111010111011111101101111111111110a
0112121012111210210112120010b2220111101110012101121b1112221212122112022102b122220112222002211220020122222221012200111111111111011111111111111111111111110111101a
1112221212012021222110101121a1110111111101011210112b1012111221111202212112a110101112222221022112222212022222202211111001111111111111111111111111011101101010101a
1112012022112201212221021201b2112210111101111221012b2220122201221112121112a111101222222212112112222222221222122220111111111111111111101110101110101100101111111a
1112211001210111212101101211a2101111110110011022121b1102201211110120222110a011111202022111100221200222221222122221111111111101111011110111111011111111111111011a
1111101111111001111101100111a1111110101111012002221a1122201121222211011210a111111110222201212222112122011022220212111011111111111101111110111101010111101111011a
1111111111111111110110111110a1111111111111112012211a1112122211111122122022a110111212112222022121122222122222220201011011101011111011011111110111011101111111111a
1111011111101011111111100011a1110111111111112212101b1222110122212111221021a101111202012212212022222122222212222121110110111011110111010111011111011111111101111a
1101101111001101110111110101a1011111111011111122201a1212222112220222012221b101111012221210022222102020221221012002011011111111111111111011110111101111111101111a
1111111110111111111101101011a1011110101010112111201a1222111120200111021111a011111112200222210222220101201022022202011011111111101011011100010101101011101111111a
1010110111111111111111100111a1100110111111111210210b1111102012222111200011a011100121122022222222222200002220210211111110011101111110111111111111110011001011101a
1111111101110110111111011011a1010001111110100001101a2201102211102221112111a111111011211221221220211222222212012220010110111011111101111011011010111111110111111a
1011111101100111101111111111a1111111011111111122011b2122212212112220212210b111111212121222222222222222221222122202111111110111111111111011111001111101111101111a
1111100111111111111100110010a1111101111111112111102a1121101211221110120020a111001200120212021220110210000102202211011101101111111111111110011010111011101110111a
1101011101010111111111111111a1111111111101111102112b2212021201122221122211b011110112011110112212212112222121210111111011011111111111111111111110111111000111011a
0111001110111111011011111111a0111100101111111021111a0222111102022221020101a111011111211100121121111120210202101111111111111111111111111101111110111110100011000a
0111111010111111011110011101a1110010010101110221212a2002120211101112120022b111101222202002201211002221210211112211011111111111011011101111011111011101111001111a
1111111101111010101111111111a1111111111111011100221b1222112122112211210122a110101210111122212200121202112121101211111111110110000111111101111111011010100111011a
0111111111111111111111011111a0111111111111101111110a1111100011110111111111a111111210102212201221000212122012111210110011001111101101011111001011110011111110101a
1111101010111111001011011101a1001011010111111111110a0111111111110111111111a100111110111110111011100111110111101110111111111011111111011101111111111011110010111a