14 16
131 116
31 107
126 58
18 99
134 98
27 75
137 19
152 53
49 100
101111111010111101110111101111110011111a1111110111100111111111111111111111111111111a11110011111111011111111011111111111011111111111111111111011a0110111111011101
111111111111111111111111111111111010011a0110111111110010111110111111111010111111111a11100111111000111101111101111101111110111011101111101010101a0111101111111101
101011011111111111010011110101111111111a1111111111110111111011111111111111101111101a11101111110110111011101111101111110111111111011101111100111a1101101010111111
101110111111100101111111111111101011111a1111100011111101111110111100110101101100111a11111111001111111111111110101110101011101101111111111101110a1111101110101111
111101111101011111111011111111010111101a1111111011111111011101111101110010110100111a11111111100111001111111000010011111111012200122210211200222b2212111121011111
111000111001100101111111110111101110111a0001111111011111101110111111101011110110111a10111111101111100111111111101111110111220120120122120021120a2010222101101011
111111111111101110111011111111111111111a1011111111011111111111011111111101111111101a10111110011001111111111101101111111011020121110221222211110a0021010121110111
111100110011001111110101111111111011111a1000111101010110111111010111001111111111111a11000111011100101111111011111111111101112022221211101021111b1101120121111111
111011111111111111111101101111011111111a1111111111101111111111000010111111011011111a11111101111010111011111111111011001111111012111111122200222b0212010011111111
101111111111011111111110111111111000111a1111011111111110111111101101111111111111011a10011011011110111010111111111111111111201222002010212112220b2220222021011001
010011001011111111110011111011011111011a1111101111111111111111011111111111111111111a11110111111111111111000111110111111111121011202121122121212a2220021111111011
111111111111111111111111111011011111111a1111110111111110111101011111101110010111101a01111011111111011011111111111101110111222120212122122201112a1122111221011111
111101011111111111110101111111111111110a1011111111111111111011111111110110011111111a10011100111111011111111111110100111110012111211021011111222a1212020111111110
111011111111010111111111111110111000011a0111110110111111101111011110111101110011011a01111111111111001111111111111101011111211111102011212200010a2202101121110101
011101111011111111111111101111111111111a1111111111111111111111111111111111100111011a11111111111101011110100111011111111111122210222110021201021a1212120211101111
111101111111111111111110100101111111111a1011111011111111000111111111101100101101111a11111111111111111111111100101001111111221211102210222000220b2122212211100111
111101111101111111110011011101000101111a1100110111011111101111111111100111101111111a10111111110111111111111110111110010110222201211110212222211a0211110121111111
111111101110111111011110110111111011111a1111100111100111011111100111111111101111111a01101111111100111110101111111110111111021012112212102120221a1012011020110111
011110111111111111011110010111101011110a1100111101011100111111000111100111110110111a11111111111111101001111111011110111001000211101022100122112b1101121121111010
111101111111111001110010111011110110011a1111101101111111111110010111111011111111111a10111011110111011111111111111111111101222111021221111021222b12210012211111aa
101111100111111110111111111111111111110a1111111100101111110011111110111111100111101aaaaaaaaaaaaaaaaaaaaaaaaaaaaaaaaaaaaaaaabbaabbbaababaababbbba01100202011011a1
111110111111100011011111111111110111110a0100010111111111111111111111110011011110101011111101111011001111111111110111111111221112221020022022101201121210101111a1
101110011111011011111111111111100110111a1011111111111001011111110100011111110111110111110111101111111111111111011110111110222110121212101221222000122101111001a1
110111111110101100101111111111111101011a1111111011110111111110011110111111111011111111011111001111110001111111111111001011122222210110220212210011200112201111a1
010111001111111111111011111111101111111a1111111010101100111111111111111110110111111100111101111101110011111101101110111111212212222121212211222221012210200110a0
011111111011111111111111111111011111111a1111111101111101011011111111111110111110110011100101111111101111011111111110111111202221121002110110221221122112110110a1
000110101111111111111111111111111111111a1011110111100111111110111101111011111101111111101111111111110111101110111111101111210011222012112120121211222212211101a1
111111111111110111010111001011001110111a1111100111111011111011111111100101001101111101111011111111011111101011011111111101122222111101121222111012112010111111a1
111111111101101111110111111110111111011a1011111111110111111111110111111111101011111101111111111101111110111111101111001110121112212102121121102022122202010111a1
111011110111101010111001100111111111111a1111110101011111111111111011111101111110111111110011011101111111011111111111111011122122202212112222002102201122201011a1
101111111111111111111111001110111101111a1100101011110010101111111111110111111111011110111111111011111111011101110110010110121012112001222021200222212011101101a1
100111111101011111110101111111111011110a0011101111101001111110111111000101111101011111011001111100111001111111111111101111212021221001222222022201211110111011a1
011111011111101111111111111100111011111a1101111001111111111001111111001010110011111111011111001011111111101011100101001111210212012212111022220121012111011111a1
111110111111111111100111110101111110100a1111101011111111001111011101011110011011011011111111110111001111111100110110111111122001211012110212011001222021210111a1
111111011110111111111011110100100011111a0111010110111111111111101111110111111111111111101110110111111111101111111101110111211201101022212211112221111121110110a1
111111111101111110111111010111101110011a1111110101101110100111001111110111111110111101111111111101011111110110011111011110111001110111111111111111100111111111a0
110111001011011111011101110100111111011a1111111101111000111111111111111111111011111111110111101110111101111111010111111001111110001101110001110111111111101101a1
111111111001111111000111111001110100001a1111101101111111110111101110111111110101111101110101111101111111110111111110111111111011011111111110111111111111111100a0
111111010011101111111111111110011011110a0110111111110110111011110111111111111101111111111111111111111111110100111110111110111111110111110220210102121211202112b1
111110111011111111111101101110110111111a0101101110110111110111111111011110110011111101101111111011011111111111111111111111111110101111111111220220211121111211b1
011110111111101111111111111101111100101a1111011101111111101111011111111111110111111111100111111111010111011111111111100111101101111110111112010222211222200102a0
101111111111111011101111110111110011111a0111111111111011111111111111111111111101011011111101111110110111011101111111011111111111111111111111101010222221202122b0
111111111111101110111011101111010101111a0111011111101111111111110011111100111111011111011101011111011111111111111010111101011111111111111221011112212211201222b1
011111111101111111111111101110110111010a1110110101111011011111101101111101110111110111111011111110111111101101122212121022212102111012221111022211111111111120b1
010101111101111111111101111111111110111a1111111111111111011011110010101111101110101111111111111111011111111111021112111111102211012102121222011111110012121200a1
001100111111010111111111011110101111011a1111011111111101110110111001111111111110111100111111111110111111111100121110110012202021001212210222121022220001212200b2
110111011110111111111111011110111110111a1111111111111011110111100111101111001101101011101011111011111111111100101112022211201222201112201212221112101220210112b2
111111010111111111011111101111111111111a0111111111111111111010111111001111111111010111111110110111011111111111111211112211112111012212200121220211211122112201a2
110111111111001111111011011110111111011a1001111111111111111111111111011101111111111111111101011110111101111001112222021221112122120102221222222121112201211201b1
110111111101011111111110010101111011111a0111111111011111111101111111111111110101111111111011101111110111111110122002212200021211101212022221221121102011110211a1
110011111011111011111110101010111111110a1011001110110111011111000011101001100111111011010110011111111011110111121120121122211112121220221222222111220120022021b1
111011101111010111111011110111110011111a1110110011111011001111011110101011101111001101111111111011111111111010020120200221102222121120101222002111122101021011a0
101011111111010111111111111110111011111a0111111110111111111011111111111111111110111111101111111011101100010111111010122202111121111101212222221210111020121102b2
011011111011111111111111111110011110011a1110110111001111111111101111000111110011110111111111101111110111111010100001121220120121202001011122211002121122220221b2
111101110111111001111011110111111100111a1111111111111011111111110111111011111111111111111111011111110011011111012222222211221121212111221220022021021021122111a1
aaaaaaaaaaaaaaaaaaaaa011111111111111111a1111101111001011011111011111101011011110111101100110111111110101101111112011102212021210112012012122222101212110221220a1
a1111111111110101110a111111011111011011a1110001111011111111101111011001001111101111111111111111111101111101111122121211222202100222112122222211100210120122122a1
a1111111111111101111a001100111101011111a1111011001111110101110110110111111111101110111001101101100111111100101112202010011202101021210021121222201112011122212b2
a1101111111011011111a011110101101111111a0111100111111110101111110111111111110110011111011000111111111111111011111211221111020212102112200220212011211101010220a2
a1111101101111111011a011111111111111111a1111011101011101101111101100010111111100111111101110101101101111111111111012121010111121110121120012021001221001120210b0
a0111101110112021102a121021002121110122b1121011111111110111111111111111111011111101111010110111111101101101111102101112222222122021101102202222111122201102100a1
a1111001111121121101a212122022100211201a1101111111111101111111111111001111110111001111101111111011111111110111012121021212111012212220222222211221002212120010b0
a0111111111122112102a120212202211121220a1011111111111111111011101111111110101111110111110111111110111111110001102021110012112001111212221221002121121122112212a1
a1111001010001221121b111222011201212112b1210110101111101110011111111110011110101111111111111101101011111111111121112122121211201112022211210021112220111010220b2
a1111101111111211202a121010010112002101b1201111111111101111101011101101111110001111111111111101110110101111111111222200112112021011202222022221221200120102121b0
a1111111101122021211b221110001112012101b2121111110110111111011110110111111111111111111010111111010011111110111121222220111201221112221122212220011102221211022a2
a1111101101122102212b211021102211101112b2211011111111011111111111111111010110111110101111111011111010100110111112221021222212101012112122022000111111111121200a0
a1111110111112122211b020100122200121222b0121011111001110111110101001111111110111111110111011101111111110110111011112022201011112222111022222002110101102222212a2
a1110111101011120202b121122022120212112b2111011110101100111111110110001111111011011101011101111111111111110111012102021202110122211011022222022202111011221221a2
a1010110011011111101b222112112011021111b1221111111111110111111101111111101111111111111100010110111110011110111100002222022201121210121111111220011111110010111a0
a1111110101121021201b222100200021112122b1121111011110110011011111110111111110111001011101111111111100001110110121220122112102022202222111111221000111111111111a1
a1011111111001122210a122012210011211111b2021111010101001011111111111111111110101101011011111111111110111111111121222112022221012221012201222101111111111111111a1
a0111111110102222021a011211002101212211b2111100111100111011011101111100111111111111111111101111111111111100110112222111112212012022012111221221111101111110101a1
a1111111111110120020a101221012100000122a2111111111111101111011111110110111111010011110111011110110101111111011112122210110121110222112111211211111111110111101a0
a1111101111122122211a221122210121221212a1210111101101110111111011101110111111110101110011110110011111111011110011111111111111111001111111110011111111101111110a1
a1011011111121122101b220111221212221001a0121101111110101111101101100111111011001111110111111111111111111011010001110110111111111110111101111011111011111101101a1
10010100110120222211b222212012121111022a2121110111111111110011101100111111011111111111011111110110110110111111111111100010011111111111111101111011010111110111a1
11110111101021011211a120221212122021211b2021011101011111101011111100101101111111110111110111100101111111111111100111111111111010111111111110110111101111101100a1
10111110111122222222b110110211111122212a2210101111111111011111111111110110001111111011011011101111111111111111111101111111111111111111111101111110110111111111a0
11111101111112101221a222210112010112020a1221110111111110111111101111111111011111111110111111111101110111111111111111111111111111001100111111101111111111111111a1
10111111111121102220a110221222202122020a1121111111110101111111001111100001111111111110110100110011111111111011111111111001111111111111110101010101101111110101a1
11111111111112011122a012112111211002112b2120111111111111101101111111111101111111111111101101111111111111111101110111101110001010110111111110011110110101111111a0
11111111111010011221b120101112210120021a1101011111011111101111111111111101011110010110111100101111101111111011111001111110111111111110111111101111100111111011a1
11011110111020002122a221102111201222211a2211011011011011111111111111111101101111111111101111110011001111111111100011111211001210221010111212221110222111010111a1
11112210101002222222b112022022021201121a1121110111111101111110111111111111101111100110110101111100101111101111111111101221000220210112001211222122202111011111a1
11102210111122222002b022221220222110222b2222120202112121122110221111110111111111101111111101011101110111001110111110111222210112022011211210202112111211111111a1
11021112100012221222b222222021201022122b1022212212201022110210222011101111101100111100111111010111111001011111111101010021222111100111201222222222011011110111a1
11121121121120002222b121022222202202100a0221122101122120111212011111101111101111101101011111111111111111111101011110111202012212021210122121210212121201111111a1
10122200111122112012b202222222212010202b1102221022222200210102020011011110110101000111111111110111111011101111000111011211210122112201011221211211211011111011a1
11000111121122121122a122020202022021202b2212221211211221111221122111111111011111110101110111111110101101111111110111111102201020222212212111112222101111111111a0
11011222112002212010b220112212121010221a0121012101210001112111211001111011110111111011111111101111011110010111111111110012002012102221101022020002211011110101a1
00111020010111001011b112111121212202102b2011112021211211200221000111111111111110000110111110111111111111111111110101011212220122112222110001201011220210101101a1
11102122202212102222b222210222012222122b0120022221111112201111102111111111111011101111011101110011011111111101011111111201111211002110022112211200011211111111a0
11111221021121210221a220202022200112221a1120222111111021101210222111011111101111110111110111111100101011011011110101110021111121212012222122212222101211111010a1
01121110021121202222a022022211022202222b1222122112211222121211211111011111111111111110011111100111111111111111101111011221121111211112202211210221122111110111a1
11022120002122202120b002022221122110220b2222200222212212122111212111111111001110101111101111111111111011111111111111111021211111021222222110212201021011111111a1
11101102222221210202b222221202012112021b2211202112121121222012011101111011001101101011101111101111101110111111111111101112101201122121112202111012110011111111a1
11112111211202110112b122122222102012222b2122122011112202210220222011111111001111011111111111011101010111111110111011001110211122112111122122210122120011100111a1
10021222020111121112b220222222222021212b0222212021221010212012012111111111110110111110111111111011111110110111111111111111212122221111220110122222110211111011a1
10120112012221101101a210202122121001222b2220121021112010112111010011101111111101111111111011111100111110101011101111111201112221022201022222212211222111011100a1
11112001122111222222b122022111210200200a0122212120021111110221112111111111111110111111100111111111101101111111111100110110010201222222122220101212201101111111a1
01121112121101210102b221222220210221202b2222122000110202202212212101111111011111110111011111011011100110111111110100111110120122121121102211012220122201111111a0
01120222021200112222b012222222222020022b2222220011121110222121012011010011011111011011101010111110101111010011111110101101121201210221222101210111202110111111a1
01122112211122112120a211200120212112222b2222020122012222122001112000111111110111111011011111111111011101111111111011111101220122212022210212112200221101111110a1
01120120221221120222a212202222000202222b0212002220120012210210121001111011111101111111100111110111110011111001010111001122200111122121011122222211120201101111a1
10110111200212221002b122202022220220202b2222202211110021020112121001111111111111011111111111001111111101111111111101011002022021222002200111221102010110111100a1
10120011201220202222b201212222010212120b0212222122102111111012211111111101111110111111011011111011111111001111011111110120121212002011200211121112101111111100a1
11100121011202121221a220210020222220212b0222212222112111200222112000111111101101101111111111101111111111111110111111101120121200111122221122210221101111111101a1
11110122111120112212b222210110210212102b0221221221102200020111221110001111101111111111110111111110101101111111111111011121221102112201112211102211120211110110a1
11001210222101122020a211022222221202211b2012002111111202222212011111111110101001111111110111111111011111111101111111111202221201012120021120222112112211111101a1
11121211112121222222b201011220022220210a2012121110122002012020112110101110011011111010110111110111111111111111110110001220011212110121221110110220202201111111a0
01112222122000111112a202200222120202122b2102212212120110222022120101011110101101101111110011111011111011111110111111110011112201122221012102202212110210111011a1
11101012222112202222a020210122121120012a2200220011212110201011222111111110111111111111011111111111101111101010111111110112211211022002101011111100001211111101a1
11121001211212210212a100202212222101221b2001201001211221212222211010111101101110101111111001111011111101111101101100111010100100211202220001210202121211101111a1
11110210221011012022b220022222122102211a1212222221111112100100121011111010111111111111111101111111011011111111111111101111111011010111111111111110111111111110a0
aaaaaaaaaaaaaaaababab221102121212212210b2222222111121212001111221111011101110111111110001111011101111101111101111001111111100110111111110101101111111011111101a1
111111111111111122010212221210210221012a1112212011111011110011110111111111111101111111111111111111111111011111111111110010011101011101111111101111011111111000a1
110011011101111112021121212221221212111a1112001010010111111111001111011101101111110010111111111111111101111111111111111011111111111111111001111111111101111001a0
110111111101111021221210011221122012112b0220221111101011111111011110010111111111111110111111111111111111011111111111011101111111111011111011111111101111010101a1
111100111111111110220221101210022221111b1220201101101111111111111110111010111111011111011111101010111110111111101111110110111111011100111111111111111111101101a1