10 1
143 71
4 104
63 100
77 110
84 63
54 113
81 21
103 112
105 31
11011101111011111111a0111111101111111010a10111110011111110111111a11011111111101011111111111011111101111011110101111111010101111111111110100111011101101101110111
11011111111111111111a1011110111111101111a11010111111111011111010a01111111111000111110111110111111111100110111110111111111111111011101111111111111001101111100111
01011111111111111111a1110111111101111111a10111110111111111111101a11110110001110111111111111100111111101111101111111111111000111101011010110111111000110111111111
11111011100011011111a0111011110111111101a11011000011111011111111a11111111011011011111111111111110110101111111110111110111111101011110111101111101110011111111101
11111111111101101111a0011111111011111101a11110111111111111101010a11111011111111000111111111110111011111111111111111110110001101111111110111111110010110111111111
11111111011011011111a1111110110010011110a01011101111111111111101a00111111111111111110111101111101111001111010011111101111111111111111111111111111111111101001111
11101111111111111111a1110110101101100011a11101101110111011111100a10101210221122222200122210112221111111001111011101111111111111110111110111111011111101111111101
11101111111111011101a1111111101101101110a11110110101111011111110a00211102221011222102201211202110111111111111110111111111111111111111101111011111101101101101111
11011101011111001110a1010111111011011111a11111101111111101011110a10211211120102212212112012212211110111111101111111111101111110111111111111111011111011110101111
11111011111111111111a1111000011100111010a11111111110110010101111a11102100022111222210122202222020111111111111010011111111111110101111110111001110101111111111001
11011011101111011111a1011011111111111111a11111111011101111111110a12021110001111202211212222210220011110101111100111101111111111111100111101111011011111111011111
00111110001101110110a1111110101001011111a11111110110111001111101a12211200121122122111122221121021111111110111111111101111111011101111111111101111111110111111111
11111111111110101110a1111111111111110111a10111101111111111110111a10020221122122212121120110011012111111111101111101111011010110111111111111011110111111111101111
11111111011111111111a1111101111111111111a11111110111010111001111a12212110121012211112222110120122100111111111111111111101100101111000111111111111101111101111111
11110110111110011011a1111011111011110101a11101001111101111111111a02021221220101011111121221211120111111101100011101110111111111001111111100110111101111111101111
10101110111110011000a1110111110111011110a11101011101111111111110a10201210021112021112111221122020111110111111111010010111010101111111011111111111111101011110110
11110110111111101111a1011011111111111010a11101011011011111111111a11111122122222011112122210201210022011112211122010211012111110011110101111111110011110010100101
11011010101111011111a0011111011111111111a01111101111110011011111a11221222221222022212202110221220112222222102221001121212111101111111111011011111111001101111110
01111111111111110111a1001011111011111111a11101111110011111110111a11102212221212221111212122022222211111211221112212010012111101110111011101101110111101011111111
11101111011111101111a0111111111110110110a11111101111111011001111a11022002011012211121121212122122122220112212021212111121010110110111101111101111101111111111100
11111111111111111111a0111101111111011111a01111111111101111110101a11202122212211102222221122122222121222112110021222122012010111111111111111100111101111111111011
10010110110011111011a1111110111011111111a11101001101110111111101a11212111221212201011110110222222222212212120220122021222111101111110111101111111111111000101111
11111111111010110110a0001000010011111001a00011101111111100101111a12201210221222111012011222221222222021200210011111122201111101110010100111101111011111111110110
11111111101011011111a1011110101101111011a11111011111111111011011a01111111201101201022121200200122212012101122111121011022011111111110111101111101111011111011110
10100110111101111101a1001100011101011101a11111011111111111111111a12222022121112220212121222112221001111101112101102100220110010111111111111111111011101111111000
11111101101110011111a1111011110111100111a10011111111111101111100a12111111211221120210221102122122021111111122221101201211111111111111011110111111111111110111111
00110101110111101111a0111111111010111111a01110110110110111110111a11111001221210121022202122201222200212101221111022022111110111111111111011111001111111100011111
01001110111101110111a1011011110101001101a11001011111111111111111a12110200102111212121221222202222000111212120111200111121011101111111111110111111111111111110111
11011011110110101101a1111011110111111010a10001111111000111101111a10110222011012020101220210102012102211212112110222111021011011111111111101101111001011101111111
11111111111111111111a1011011101111111000a10011110111110111111111a02212122212122002011011122210222111011101211122101221211101011111111110111111111011111110010111
11111111011011111111a1110111111101111101a11111110011011111011111a10122221120112112222121222121220222122111011221101212022011011111111011111011111111101111110111
10100011111111111011a1011111111111111001a11111111111111111111101a11221212102202121112121010222112121212211221222012221122101111111101101011001111010011110111111
11110110111111110011a1111111110110011111a11110011101111111110101a11202121222211021102021122222222121101221221211111222111111111111111111111111111111111111011110
11101011011101111111a1111011101111001111a11111110111111011110111a11211212010102121101012012222212222222111112211001210011011111110011111010101111111111111111101
11011011111011110111a1101111010111111111a11011010011111011100100a11022222121212112122001110222220101202001222120210222211111111100011110101101110101111000110101
11010001111101111111a1110111111011110110a01111110111111111011111a11112111111220001122111112212200000211120220122220111120111110011111111100110100101011111011110
11111100111010011111a1100111101111111101a11111101110111101110111a11201222111112120111100100022222122101102122221121211020111111010110111111011011010111010111001
11110011101110111111a0111111110111111111a11111111111111111111111a10101111101101111111111110221121011101020121112101112112111111101111100101011111111111111101110
11011111011110101111a1111111111111110110a11111111111111011011111a11111111111111111011111110211220122111120122101110222202111110011111111111111110101101111111111
11101001111101111111a1111101101111111011a11111111111111111011111a100101111011111111111111121101211012222101212111011121001aaaaaaaaaaaaaaaaaaaaaaaaaaaaaaaaaaaaaa
11111111111110010011aaaaaaaaaaaaaaaaaaaaa11100110101101011111111a111111110111111101110101120221122212100111122211212011111a1110111110111111111111111111111111101
1011110101111111101111101111111111110111011110101111111101111111a010111011111111011111010110211211010021112010012111101010a1111011101111110110101111111011111111
1111010011010111111111000011111001111111111110101011101111110111a111111111011101111111111102222122111210222110221122011221a1111111111111010100111101011111111110
1111011011001101111111111110111111011101111111101111111111110110a111111111111011111111111112022202222221010100222211021221a1001111101111111110111111111011111111
1010111101000011111101111100110111111101111101101111110111111111a111111111010101111101010112220111211202202212101121220221a0111101111111111101111101011101110110
1011111011111111111111111101101111110110001111111110011111111111a111101100111111111000111111012121220120002211102001100201a0101110111011100111111111011111111100
0101011111111110111101101110110111010010111111111111111011011110a011111110111011111111011101222200200122001112111221201121a1111111101110111111111011010111110111
1111111101011111110111111111111111110111111101101111101111110111a001111111101111110111111110110110111110011111101001111111a0111110101101011111111111110000111101
0011100100011111101111101111111111111111011111111011111111111111a101101122221121120002221022211200211011111100011111111111a1110001111111111111111011111011111110
1111111111111111111011111111111111011111111010101001111101100111a010020200202210111201112212010220021111001111101011011011a0110111101101111011111111111111111111
1111110011001010110111011111111111111100111011110111111011111101a111102212211102222120122112112111121111111000111110111111a1001111101111100111110111101111101110
0111111110111111110111011011111111111111101111111111100011111110a111121211122112212111210201112110221111011111111111011110a0011111110011111111011111110011101101
0110111111011001111111111111111101110111011011111110111101110111a110121020021212212221221221200101221111111110001101111010a1011110111011011111010111111011101110
1111111101111110111111111001111111111101111111111111010111111111a101112102210121121221102022120102121100111111111001110111a1111110110011011011011111111001111111
1101101100011110000111111110110010001111111111100111111111111111a111112101220121211221212212122111221111110110111010101111a1011100111111011111111111111110111110
1111100111101111010111111111111100111110111111111111111101111010a111122122121112001210210211011222210111111001011011111111a1110111111111101111110101011111111110
0001111111110111011111111111111011111111111111111111011010101111a111102122210022102222210110012111121111010111111111111100a1101111001111000111111011111111001111
1001111111111111111111111011111011111011010111111111111111011011a111101222102121222100211211102210211110111111110010111011a1111111101011010111001011111111111110
0111111111111100111111010110101111111111111111110111101111111011a111011121112212202021212111111222121101011011001111111111a1111111101111111010110111111101110111
11100010111111101aaaaaaaaaaaaaaaaaaaaa11111111111111101110111101a110110112211222212221122110211102200100101111011111111111a1111111111011111110111011011111110011
01101111111111100a1101101111111110111a11101010111111111101101101a011100222221222022201202222002102121111111111111001111111a1111111101111111111111100111110011111
01110101011101111a1111011011111110110a11011111111111110111001011a011121221111102102112222121211121010111111111011111111011a1111111110110111110111111111101101111
11101010111101111a1111101011111111111a11111101101111011111111101a101121110222121200212021022221112000111111111110111111111a1110111110101111110100111110001111111
01110111101101101a0011111011110111111a11110111111101111110101111a111012202022221211200012022002221111111010010111111111101a1111111011111111110011011100110011111
01100111111011111a1101111111111101001a11111110111111011011111011a111122022112212112221012211001021220111111111100101111011a1011100110111010110101111111111111110
01111101011100001a0100101111011001111a11111111111011111111111111a111110112202221001102100011201211200101111011111111111111a1011110111111101111110111011111101101
11111111010001111a1101111011110111011a01111111101011101111111011a111020200021122102202022221120220121111101111110111111101a0111111011100011000111111111111111110
11111111111101010a1001110111111011110a11111011111111111011101010a101101211011222020221120021202021211010110111110111101111a1111111111110111111111111111111101010
11011110011101111a0110111111011111111a11101101101110111111010111a111112222212122000111120102120110211111001111111111111111a1011101111111001101111010111101111111
01111111111111111a1111111111111111110a11111111111111100111011111a111120111222012112211022120101221221110001111101111100111a0111111111101011101111001111011110011
01100111111011111a1110111111011011111a11011101010111101111111110a010120122222121011022121211222120221110111101111011011111a0011110111110111111111111111101110111
10111111100111110a1111011011011111111a11111101101011111110111111a111112021121212220211212200222122021001011110111101101111a1111111110111101111011111111101111111
00110111111011111a0100111111011101010a11111111000011111111100101a111121120002121211021212212011211021110011111111110101101a1111011111111111011101111110100111100
11011110111111111a1111111111111111111a11111111011111111100111111a101002221212222111102121102222112111011110101011110111110a1011111001011000011111001101111111111
10110111011011110a1111100110011111110a01101111011011111101110101a111011001101211111001222211122112120010111111111110011100a1111111111111111111111110111110011111
11010101011111011a1011111110011111001a11110101111111111011111000a111121111220101220021210122222121210111111111101101010111a1001110011111111000111110011011011011
10111111111111100a0111001111001111010a01011110011110010011111011a111122112010121121221211121211022201111111101101111111111a0111111001001111111110111111111101111
11110011111111111a1001111111101111110a10111011111111110100111110a111102211021221111211121202212121201110111101111111111111a1111111111011111101101011110111111101
11110110110010011a1101111100101110010a01110011110111111011111101a111111011021211101101200122201120200111111111111101111111a1011111111111111111110111101011111111
11111101111111011a1101111111111001011a11110011111111101111010111a111111111111111111111011110110111011011111111111111111111a0111101001010111111101101110001111001
00111101111101111a1111110111111111111a01111011110101111011111110a111111110111111110111101010101111100110110110111111101101a1101110111111111001101111111111111111
11111111110111111a1110111011010011111a11111101111001111111111011a111111011111101111011101010111111111111001001101011111111a1111110101010111111111011111111110111
11100111110110011a1011111111111111011a11011111111111111110110111a111110101111101111111011011101111111111011101110101110111a1111111111001110101101110111111110011
11101111111111111a1111111111111101110a10001111111110110011011101a111111101111111101011111100111111111101111100111110111110a1101101100111101101001111011111001111
10011111011111111a1111111110011111111a01111011011111111110111111a110111111100110110111111111111001111111110011111011011011a0101110110110101111101100011100111101
11111101111111111a1111101111111111111a11111011112020211100022022a112122211222111111111111101111111111111111111111111111111a1110110111111111111110110011010111111
11111010111110101a0111101101101110101a11111111011222212022111022a122212121111020111101101011111110111011101111111111101110a1011111111111101011111111111111111111
01111111111101011a1101111111010110100a11111101101100212101022112a111122111221101100110001111110101100111111110111111111111a1111110111000110111110111111111011111
11111101101010111a1111111001111111111a11011111111202022012101112b221210210112011010011111111111101111110111011101101110111a0101111101111111101111111111111111111
01100222212210222b2211111111110111101a01111101112222020121021111a211221210212210110111111111111111111111111111111111011111a1111011110110111111110111111111111111
21221222002120122b1111111111101110111a01001111102012110021121112a021201221210101111111111111111111111001011101101111011011a1111101111111111111011111111111110111
12021110211111121a1010111111101111111a11110111112002201022022102a021102202121121111101011111111011111111110111111010110010a1101111011111011011101111101011111111
11111121122210212b2201000100110011111a10110110110012221202120110a201222201010210111001110011111011111111101011111111111111a1101111111011111101100111111011111101
01011220022100122b1111101111111111011a11110111110222222011121212b221210221012221111110111110111111110000101111100110101011a1101111100101110111011110111111101111
11112211211221201b1211110111111111111a11010111111212121212021112a021122221011221100011111111101101100101110111101011111110a1111011110110111111011111111101110011
01222121002210012a1110101101100111111a10000101112112121121112212b222211022221121210102202021100111101111110111011101110101a1111011110011111111011111111110101110
01221211022222012b1111101111111111111a11010110111222112211201001a222120222222212000211220001211101111111011111110101110011a1111101001111101110111011011100110011
01122022111112122a2111111111111111111a01111111002001221101120122b221212121102221200201202122220220211121122222200221000110a1101111111101011111001101011011111110
11122220121200202b2011111111011111111a00201212221221222210222120b020222022212101222222020200021221212220011112211222212111a1101111110111111111110111111011111010
11222120011120121a2110111111111111101a11121020120212100211022122b122221122221110211212112112221222211122121211102211220101a1101111110011111111110111011011110110
21020122112001212b0211111110111111110a02021102021122222022221112b222222222221001211211210222221110122112022001202021112111a0111011111010101110111110111010111111
11022122011110112b2211010111110011111a12211201222021212121122000b022000222221222001120222222111011001222211111022212102001a1111111111111011011111111011101111111
22112102222112202a0211101011111110111a10202122122222222222022122b002221002020012112201012202222121212121212210110002110111a1111111111110111111101111100111111101
10220011122112011a2111011111111110111a11201222212022222222202010b222122201202201022010110222211111202122222101121222212111a1111110101111001000011111101000111011
22020120111122100b2201011111111100111a11202021112220212012202222b021122220212020111221202022202211122221122112120112022111a1111011111110011111111110110001011011
00102112212022112b1211111110111010011a12222111220212222222022222a010122221221221121121112222200011202122221112012212222111a1110111111010011111111101111111011111
20201202221221111b0111111011111011111a11021222220122212022222202b222221222212000012222000222002122122112121222211111111110a1111111111111111010111111111111111111
20121120112220111b2110110011011111011a10112111122020212220221202b202222221222101121021210202211101101102200202121022112111a1111111111111111111111101101101011110
11201222122222212b1111101111001111110a11121010020220022120210112b222200222122122212202122212222112220212120211001112210111a1011101011010101111011111111101111111
11102120212112221a1210000111111111010a11022221012221222212221222a202221220202222211111002120212112101222102121111200221111a1111101111101111111111011111111110101
22021120221010111a2211101111111111010a11021112112022222120212222b012222211202100102021020121221222021211002112211212221101a0011101111101010111111010101000010111
11122112011011111a2210010101101101110a01221122112012122222212222b220202022100201222210112210022121012210011001212122011111a1111101011000011011111110011110111100
10111012012202012a1201111010011101111a11022122122221202222022222b222222222222122112120202200211212202121212221121201212011a1111011110111111011001101011100101011
22211212121021020a0210100100111111111a11111011212201020222221002b222122002121221100122112120200021212102222111011211211111a1111101111011111101101011111111011101
01111121111212122a1201110010101101111a11212221022222212222220221b212220222221121221110221222111211121112120101222111222111a1101111101110001101110111111000110110
01212122202112120b0211101111101101001a12222100212222221202222022b022200212212220121210100122212122222111222021222210121111a1110101010011111011111100101001110111
22122211212222112a1211110111111111011a11021110122020222121211121b022020002021112122221221222212022112111202101122121122110a0111111111111110011111111010111111110
22212202222111200b2111100011111111100a11201012210112021200101122b222112210211012011211022112022020211102112201122022011100a0111111111111110111101111111111111111
22201022122210221b1010010111111111111a02221110112121022122200022a202221102112220220121021120222112220201210212210102121111a1111110110110111110111111101000011111
bbbabbabbbabbabaaa2110101111111110111a11221122200102111221121012b020222222112202101221102202211111122202122012221112021111a0101111111101111011110101110110101111