34 112
145 14
111 34
80 36
89 95
126 105
7 30
98 22
48 14
5 72
111101111110011101101111111100a1122021112212111201210a1110122221111001101111110111100111111111110111101110111110011111111111111100111011111111111111111111011111
111001111110111010110111111110a1122222110012110021221a2220022201011110011101111111101011111111010111111011111001111011110110100101011111111111101111111111011111
111111111101110110111111111111a1122012220221010012121a2202221121111111101110011111111111111111111101101011111111101111111110111111001110111111111111111111111111
111111011111101111111101111010a1000112120201201122020a1020012120011111101111111111011101111110111110111111111111010101111011011011001111111101001111110100011111
011111010111100110111110111110a1121020111102022111222a2211101212011011111101111111111111011011111111111111111111111110111011111111111111111111101010111111101111
111111110101101110111111110110a1102011101222200202222a0111122222111110111111111111101111110010111111011111111100101101111101010111111111110011111111110111111111
111101111111110101111011110101a1110211221211111121211a1112210211111111111110111110111101111011101111111111111011111111011000111011111001111111111111110100111011
011110111100111111010111110110a1112121211110210022021b1222210210101110111110111111122111221012102001101222111122220001111011111011001111111101111011111011111110
100110110111011111111111111111a1101011022222122222111b1122211021101111111111111111111222120002122121101222201212111111011110111111111011110100111011111111111011
111011111111011110010101011111a1111112222012111122222b2112221020111111011110111110110010110221112212020111220020211011011111101111110011101011111111111111010101
101100111110111111111111111011a1111222121021102222212a1101122102110111101001111001101012120200221121201122121110011011101101011110111111111101111111111111111111
110100111000000111111111111111a1112122121110212012122a2122112122111111111111111111011221001111111110222122200110111111001111110110110111111101110111111001111101
111110100110111111111001010010a1001012121111112111102b2221222201111011011111111001102120102110012212122122111121211111001111101111011011110111111111000111111111
100011110011011111110101011111a1102200202112122201122b1012111112111111111110011101121122021010202221010001102212111111111111101111111011111111101111111100111111
011101010111001011111110111011a0112021212012021121200a2112111211101111111110111111122011222011121121011110111112200111111101000111111111111111111101111001100111
212021121102022121221211111111a1102121212122122221121b2222122012101111110111111111121102211010000211212121011012201100111111011111001011111111001111011111111111
220210022022211122212100001011a0100020100002122022211b1121102112101111100111111010111201011211122202022220002021100111011110110100011111101110101011111111110111
122022221121212002221210110111a1112022200021121111200a1110221121111111101110111111012110212111012211221022122222121111101111111111111110011111001001111110111101
202101101201200221022101111111a1020112202112212102110a1201122212111011111100110110121220022122221111221212020222000100101111010111111010111111111110111111111111
101202202112021121000001111010a1121211112102210212021a1121112010111101111111111011110112201222212202222201121212202021221011101111111111110111111110101111010101
121211110122101101200201111111a1102121022100121121122abbabbbbbabaaaaaaaaaaaaaaaaaaabaabbabaaabaabbbabbaaabbbbabbbb2112222111222111111111110110101111111111111010
220122202211212222221100101110a1011210112221210212012200111210121212211011221121012222022122112022122122202222220b1210120121202111111111110011101011110101111100
120220021112110211122121110111a1111102121120110021211111011102201122200111122210121122122222212112220222200000021b2001221212020111110111111101011111011100111110
102011221222222210110211110111a1002022122121002112120010122210011220000122001100122020222212002212022220101221222b1211000211222001111111110100101111111110011111
121011202112201102012200001111a0120122211122211201222201112112211120011211212121011112220021012121212222111212002a2211110112220111111111111111110101011011111111
110221020121220210201211111111a1110011122120110111220121112111211100212211011120220221220220221021011102021011222b0211022222121111001111111011101110111001111010
112121011121121221010001111110a1111110121211012001222212001222221021111000210221110202222222021220110112222012220b1121110112100111111111101100111111111111101111
201221211120010221011021101010a1110101221221102011121111212111101222102002022022202110222202201222202212211222202b2121202212002101111111010111111110101101101111
222212212201121100122011111101a0120222221112120112111012212222211012200222210221122221212222222202210212122022000b1201211222212111111011111110111110110111101111
211101112221022212100121111111a1012221210122020102201202112000021112101112212112012222012122212121202222012221122b2202101221110110101111111111111111111011111110
021201102121002201112021111101a1111010111010111110111101101111011012202211210111202201112012122202221222021222002b1121111211120111011111101011110111101011000100
110011211211102120112201111001a1011111111011010111101111111111111102012212112101121202202212222222222220122222210b2102202010011101011110111111111111011111111101
102122111012201121111111111111a1111111111111111111111111000001001112222101112112210222210222122200201122200220102b0002211220221111010111010011111110111111111111
221202122021022100112101011110a1111111100111011111110011111111011001001012110122220122221222220210122202022120022a2220121012111111101001100111111111111111111110
221022110221222222001200111111a1011111101011111111011111101111111212022201222210121021222222222210122222222212210b2111022201222111110111111111111101111111111111
112212121010210121122211110110a1001111111111101101111111111011111121222212001212012012100200222202121212002222220b1221020221212111101111111011011111001101110111
021211011221220112212221011111a1111111110110111100111111001110101112221222001012122202022222120221002212221222220b2210111112210111111111101111111101111110101100
021112002122211112111221111111a1111101111110101111111110111111110121201112110012112222200222222102101012221220212a1110100120012101111110111111101110011111110111
112220211012111202221110101110a1101011011110111111111111111111111202212121011212110121122211121021112210201101001a2111100222110111101110011110111100111101111111
211121212111022122121101111111a0111111101110111110111111111110101022102121210222110112201112111221221110211221222a0100022100000101001111111111111011111111111010
122201222221102202021111111101a1101101111100111111111111110111011111100120112201012201112220110120021112221122220b2222101022112011111101111111111111111111101111
120211200211221211121111111011a1111110111111111111011111111110111021212220011211211220110110102201200111212211201b0111122211122111100111111110110001011111111111
102201112122111122222221010101a1111111111111011111110111110111111211210122202211111121121101121101220222122110212a1210011111102001111101011111101111110110101110
121101210101011110220121011011a0111011110101111111101111111111111002211112021120100211011212001212121222101012111a1002221210011111111111111111111111111111111010
021211221020220202122001111111a0011111111111101111111101111110111212222110121210112202021011112221112112011211210a0120121112122111111110101110011111111111111111
102112102111011102102011011001a1111110101111111111101001011011011122202110120111112211221112120220212221012212211a1120201002222111011111111001111111111110101110
000101001111111110111111111101a1101111111010111011011110110110111122202011112122022122212211202121211212001122210a2011000121101110111111111110110111110101111001
101111101110110111011111111011a1111110111111111110111101111111111102022212110211101121222122121222210022211022211a1121122121111110111111001011111011111111111111
101101101111111101101111111010a1110011111111111101100110111010110000110221101120022221212211110220121011120121001b0011212221200101111100101111111111101110011101
101111110111101111011111111111a1011111011101101111111111111111111102212110212211112212112122220220022210221012221b2121210102101101110111111110111001110111111111
111011111110010111001111111111a1111110100100111110010111111110111121222010102010201022212210112211110101111001011a1011011111111111111110110111101101111111011011
110111101111101111110111011111a1111111100111111010111111110101101211221200221222112121011201201111110100111111111a1111011111111111110111001111010101110111111111
111111111100111111111110111111a1111111101111111001111101111111011110111011111110111101101111110101111000111100011a1111111111011111111111111111111111101010101101
111101111101101111110111101011a1111111111111001101111100111111011011111101111111111111011001100111100101111111110a1111111111111010111110111000111111011101111111
010111111111111111111101111000a0111101110111011111110111100111110010111101111101111011111111011101110111111001111a0111110000111101111111111111111101111110011111
111111111011011111111111111111a1110111111111111111110111111101110101111111101110111111111111111111111111101111011a1011110111101111110011111110111111111111011110
111111111110111101111111101101a1111111111110101101111110111010000111111101101110111101111100111111110100111011011a1111111110111101111111111101010110111110101111
221021111112222211002101111110a1011111111111111110111111110111111011111111011111111101110100111111111101111011111a1101010101111101011110100111011111111111001111
200120121022121022211111110111a1011111110011111111001111101010111111111111101011101110111110111111110111110110111a1011110010111110110101111111101011111101111111
220211221212212111022010111111a1110111110101110111100111011111111111111011111111011110101111101111111111011111110a1110101011100011111111100111111101101111001111
220211122111202222011110101101a1011111111111111101111111111111011110011011011011110111111111101011110101111101101aaaaaaaaaaaaaaaaaaaaaaaaaaaaaaaaaaaaaaaaaaaaaaa
001201000212210121111111111101a110111111111110111111110111111111111111001101011110111101110101011111111111111111111111011111111111101111101110111011111111111110
120100221011121120221000101111a111011110101111111101011111110101110111101111101011111111011111101110111111111110111110111101010011011100010111111111011111111100
211110002101022121211111111111a111111110111111110111010111011111011111111111111101111111111001011101111111111110101101111011011100111100111111111110111111001110
111221201220221222122011110111a101110111001111111000111111000111111011111111110111101111111101111011111111110110111101111111001111011111110111111111111011100101
121122121222221011222111111111a111111011111111101111100111100111111101111111110110010111110111111111011111110101001111111111110011111111111101111111111111111101
221220121221022101221111111111a111111110101101101111001111111011110111111111011011111111111111101111111111111110111011011110111111111110111001101011111011111111
211100222101212112211101110101a111011111111011111101111111111111011111111111001010011011111011111100011111111011101111111110011110111101110111111111111111111011
002211011022122111212111110111a110111111111110001111111111111111011111111111101000111111001111011111100111011111111111111011111111111111101011111111111111111101
211112112100012202201111111011a011111111111111110110111011101111110110111010111101111110110011011101101111111111011101111111100111111111011111011100111110011111
221122122122112122120111011111a111111111111101111011111101101111111111111111111110101111111100111111111011101001011100111111111111010101010111011101010111110011
012222200220211122210110011101a011111011011111101111110111110100101110011111011111110110110111001111011101111011011011111111110111111111111110111101111111111011
001122210221211022212111011111a111110001111111111111111111011111111100111111011111110111111110101111110101111101110111110111010011111101101111111001011111011010
102211111220012111211101111011a100101011111111110111101111100111101111111111100110011011111011110101110111110111111110100111111110111111001101111111111101011110
121201122122122101221010110101a101111111111010101111111111111111111111111100101111111111011111011011111101111101111111111110011111111101111111111011011111011111
021210112102122122120011110111a111111011110110111010111111111101111111011111010101111110101100000011011110011111111001011111111011111111111111111111011110110011
112121021121210222210111011111a111011101101011000111111011111111111110011001010010111110111100010111110111111111011110101011111111111110100011111011110111011111
211002220112011111211111011111a111111011101011111101001111010111001101111111111110111011111101111110111101111111110111011011001110110011110110111111111111011011
110200111112212212111011111011a111110011101111111101111111111111111100111110011111011111101110111111111000101111111111111001110111111111111111110111110110110111
110211bbabaabbbbaabbbaaaaaa110a11001111100100101011111110100aaaaaaaaaaaaaaaaaaaaaaaaaaaaaaaaaaaaaaaaa11111111110010111110111101111110011110101111011111101011100
122212b1221112102121111111a111a11110111111101011111111111111a011100111111102120121201011122101121120a21101111101111111010110111111111101111110111011001111010110
221121b1222120222211110111a111a10111111001110110111111111110a011011111111100212202202011112221221112a22221101100111111111111111111111111111111110111111101110111
120122a0212210212112011100a011a10111011011010111110111111101a111111111111011020012222122021222110111b01220111111111001011110101111011111111101111111111111011111
111221b2211121122212111111a111a01111111111101111111111111110a011111111111112112122122220210200210120a11221011111111011101110111111111111111110111111000011011101
211011b2112101021210211101a111a11101101101111111110111110111a111101111111112021211222211212222221012a22111111111111001111111111111111111011101111101100111101111
210212a2122111121012111001a101a11111011111111011111101001111a111111101111011022112010002222012111112b11221100101111111100110111111010110111111101011100011111011
121101a0121222122222211101a111a10111111111110111111111111111a111111110111122221111111211212121012122a11020111111111111101111100111111111111000000111111011111111
212000b2112212220112111101a101a01111111111111110111111110011a111110111111111111010112222122101002200a22111110111111111111110011111111101111111100111101101101111
011111a1111011011111111111a111a11111110110111111011101111111a111111111110112102120222011112121221212a21001111011101101011011010111111111011101111111111111100011
110011a1111011101111111110a000a11111111011100111011111111111a101110011011101211222111121022011112200b22221111011110111011111010011111111011011011011111010011011
110111a1111111010111111111a111a11111101111111101101011111111a010101101111112200122112211112121102121a12121111111010202211211212202211122211002101011011111011011
100111a1101101110111111011a111a11111101101101101111111111111a101111110011122212020202202221121112111a21220011111202220220100121012112211122211101010011101111111
101011a1111110111111110111a111a11111010011101111110111101101a111111111011020022121111121202012111100a11211011112221211020220220211220211120101110111101111111111
101111a1011111111101111111a111a01011111111011110111111101111a110011011111102202210212111122121110012a02211010002102101200110022202201111222222111111111101110110
111011a1111111100111111111a101a10111110111111011011101011101a111100111110112121122222122010121112020b01221110111211011102120022102220212021221100110111111111111
111111a1110011111111101111a111a11011111011111111111100111010a110111011111011100220002222122112122222b12120110112111111101200220100121100202222111111001111111110
110111a1111111011111101111a100a11111111101111111110110111111a111101111111112222001222000221022021112b02111111102222212002122111022201222102111011110011110101111
111101a1111011111111111111a111a11111111011010111101111111111a011111111011111222220112111112212001111b10221011110002100112121112222221022221221111111101111111111
101111a1011111101111101110a101a10101111011111111111110111111a111111110111101222101000121011122022002a10110111012222121122101211211002221212220111111101111110111
111111a0110111111111111110a101a111010111aaaaaaaaaaaaaaaaaaaaa011111111111112221110001212110202211221b1211111001221221222abaabbbbabaabbaabaabb1111111011011010110
110111a1111111010111111111a001a111111111a11011111101011111110011011011101122101221112012001102111112a2020111111121111211a1101022212102121211b1111111111000011111
110111a1110111111111010110a111a111111111a11111111111101111101111111111111122011102222211200002221202a2001110111200120021b2212211111011211221b0111111111111111111
101010a1111111110111011111a110a011110011a11111111111110111101111101001011122111220222012222212022121b0010111111001010102b0211122022111122221a1101011011111011011
110000a1011111111101111001a011a111111111a10111111101111111101111110111001111002221011112120222110211a2002011111222120122a2012211220102210211a0011110011111110111
110101a0111011111111111111a111a000011111a11111110111101111111011011111111111120221201122201112001212a0011111010110222122b2121101120102022120b1111111111111011111
101111a1111111101111111111a111a101111101a01011101101111110101000111111110022121111200111212010021201b1202101111111211112a2102021211122212011a1110111111110111111
111111a1111011111111011001a111a110011101a11011111101011101011101111110111112002220210020112101211222b1202111010022211020b0112121011120220111b2110011111101110101
011110a1111111111111010100a011a110111111a11101111111111101101111111011111011210212222112122112012021a2111111111220002112b0011021012211101212b0111101011111011110
011111a1111111101111111010a011a011111111a11101110011001111011011110101110111012021220202211220222112a2211100111212211121a1112001211112112211a2001010111011101111
101011a1110011111111110111a110a111111110a11111111110111111111111111011111110101222122211112022012220b1020011110012111212b1111112112021212122b2111001111101101111
111101a1111011101111111111a111a111110000a11111101111111111101111101111101121211100120200202222002022b1112111111121120021b1121102122211101222b1111110111111111011
110111a1111111110111111111a101a101000111a11111111001111110111111111110111111011101011111110111111101a1111100111002101211a2010002122122222222a1111111111111111111
111011a1110110111111110111a111a101111111a01001110110111110101111111101110110111110111111001111101111a1111111110012201220b1221112110112112021b0101111111111101111
110111a1011001111101001111a110a111101111a11111110111110111101110111111011110111111110111111111111111a1011111111200001122a1022202001222010211a2111011011110001110
111111a1111111111111101111a011a101110111a11011111110111110111111110111101001111111111101100101110111a1111101101121211221a0101002212210221211b1111111010111001100
111111a1110110100001011110a111a111111111a11110111111110111101011100111100111111111100111111011111111a1111101111122220211b2222201122221221122a1111111111011111111
111111a1011011111101111111a101a111111111a01111111011111111011111111110011100110011111111111110111001a1111111111112211002a2212121211101211221a1111111011001111100
111111a1111111111111111111a111a111011010a11111010111111101111101111111100110010111111110110011110100a1101101100222212122a1121122110111122210a2001111110111011110
110101a0111111111111101011a010a100111101a11101111101011111111101111011011011111110111011011111110101a1001111111212021202a2120021222211112212b2110011110011011110
101011a1111111111101110101a101a111111111a11110111111110101011001111111111111111010111011111101111110aaaaaaaaaaabbbaabbbbb1220121120221212110b1011110111010110011