141 47
1 21
147 17
138 102
0 71
126 74
137 17
55 97
25 22
119 33
11110011110111101111111011111111111111001101111101111110a1111101110111111111a1111111100a11001110111110111011111111001111111111111111011111111101111a111111111101
11111101011111111000111111101111111101111111111011111111a1110111110111111111a0111101111a11100111111111011101111111111111111111110111111111111101111a011011111111
11111111111001111111101111101110111111111111110001111110a1101111100110111111a0100110000a11001011111111111011111111111111110212201111220012121122002b212221221112
11001101111011111101111011101001011110101111111111111111a1111010011111111110a1110110111a11111110001111111010110111111011112101212021221202222210210b212112121220
01111111100111101111111011000111011111111111110001111111a1111111111111011111a1011011110a11111111111011011111111111101011111202012122221020022220122b001222110212
11111011011101111111111111111111100011111111101111110111a1110111111111101110a1110011111a10111111100111110101111111111010010010122121112212222220002b112221112221
11111110111111111011101111011011110111110011111110101110a1111111101101101111a1110100110a11111110100111111111001111011110112102120112210122220220100b220201212212
11101111101220210222112111211221220111122101110111111111a0111101111011111111a1101111111a11111110111100111001111111101101110201202021212112222200222b221022222212
10001100110111122200222102112112120202011111111101111111a0111111111110111110a1111111111a11111111111111111111111111110101102211122212102211222122200b022222211110
01111011111002212202122120122111112212020011111101001111a1111011111111001101a1111101111a11111111011111101111111011101111101011012111221102222222212b122121212111
11101111112012121011200212021222111012100111011111111110a0110011101101111110a1010100110a11110111011111111111111111111101111011202212222222220221211b200121110212
11111111111222221222201111121121222102000111111111111011a1111111101111111000a1111111111a11111011010111100110111111110110112021112101222211201222220a121202220211
11010111112212122222212022120212212112111110011011100111a1111111110001010111a1111110111a10110111111100001111111111111111010022221112202212222121012b220121101021
11110111001110120201222200112212222020221011010111011011a1111111111111101111a1011101111a11101111111111101111111111111111012222201122200221220222022b022221221112
11101111012212222121211222010122221210212111111111111011a1111111111110110101a1111101011a01111111111111111111111010111111111202120222222002122201222b112020102101
10101111110121111001102122110121110111221111011111111110a1111110111111011111a1111111111a11111111111101011111111111111010102222121112221201012200202b201211022100
11111111010212121011101212211210012122021101010111010101a1110101111111011111a1101101111a11111111111111111111111110101110112021211210100222122202120b202212200212
11111010102020012222221122012121211010121111111011011011a1011100110111011010a1011001110a11111110000111001110111111111000012110202112122212211112220b212222112122
11111111111212122122102021120221221211102100111101111011a0101101111101110111a1101011100a11111011111101102110012210101200111122002212220002222222200b222220121212
10111111110012222221012012202001212211120100101101111111a0111011010111001111a1100011111a11111111011111002122222211010201120011221222222222002220212a211221220222
11101111012001222110212202211212021222222111111111110111a1011111011111111111a1111101010a10001111111011000112111211010121022122212212220120120121002b012201120111
11111011012111110102011100112121122221110111110111111100a1101011000111110111a1110110110a01011011111110110112122122102222112020202201222222122212221a222211021210
11010100112022202120122001110202211001112110111111111111a1111110100111011111a1111101111a01110111111100110111120021210221211212212020011122122222222b222201100122
01110101111221202112201221110221111122220111111111111111a1111111110111111011a0100111111a11111111101111112112111211220112211222002012122022220211222b220211221212
01111111001111112112220221012201122001212011111101110011a1101011101111111101a1111111111a01101111111110112121212022111122202220220210222221222022112b022120012200
11110110111111202222120101120111122102222111111111111111a1101111111111111101a1010110110a01110101111011112122222110012222222212222010022221210212211b222222110221
11111111111111202221110221220021021111011111111100011111a0110111111111110111a0010111111a11111011010111002112222102210212112220222220202012221211222a222001111220
01011111112020211001110010020121111101201111111111111111a1110001111111111011a1011111011a11101111111110101021221111101112020000022222212221221202212b110222012112
11111111102222212211101212112211121121211011100111111111a1111011010111111111a1011111111a00001101110111102102121221211212000210202011222222222201222b222220112120
11110111101111102021112022112111021200221101111111111110a1111101111111100111a1111011111a11111111101111111001121102221212212222020222210122122121122b221021221201
aaaaaaaaaaaaababaaabbbabaaaabbaabbabaaaaa101111111111011a1111111010110111111a1111101111a11111110011111012121111021002112020112012112222222022022212b222202111102
1101011111110211210002110011202212021212a110111111011111a0101111110111111111a0010111101a11011111110110112122101112210100212220020220202221002202202b220221021111
0011011011111110222012112222111211001111b011111111110111a1111111111101111110a0111011111a11110111111110012212212202210212102002122220202212220220221a212022102111
1111011111201110011221221221110220121202b111110000001111a1110101111111011101a0111001111a01011111100111112101111121011111022021221101112111111011111a101111111111
1101111111122020022211110112211120211001b101111111111101a1101111101101111111a1111101111a11111111110011101222211102122110012220221102102010111111111a101011101110
1111110011122102120212211000221211211112a111011111111111a1111011111111111011a0101111111a11101111111110112222102202021211112011101021121110001101111a011111111111
0111100011122211121212211110121022222001b011111110111111a1100110111111111101a0110111111a01101111111111112211102100212122221111201121100111111011111a011011111101
1100011010021120221220101221022021010212a110111111111011a1111101001111111110a1111011111a10111111100011100222201221211111220210122012111111111101111a100111111111
1111111100111010100101110111111100111110a111110111111110a1111111000110111010a1111110011a11010111111111101211121111210102222220112222012110011111111a111111111011
1110111111111111101111110111111111111101a110111111111010a1111011111111111011a1111001111a11111111011101011120111201102112010112112110111111110111111a111111110111
0111111110100100011110111001111111011010a111111111111111aaaaaaaaaaaaaaaaaaaaa0111001101a11101000011111110112212110122120212201212221221111101111111a010011011101
1101110111111110111101111101111010011011a1111111011101111101111111010111111110111101110a10110111111111100121201202101111200122101111011111011101101a111111110111
1101111111111111110110110110110110011110a1111111111111111101111101011111111111101111111a11011110111111112222021222010112021120221102111001011111111a111111011111
1111100011111111100111111011101111110101a1001100001111101111111111111110111111111111111a11101111111110112111212221221211022022212021222101111010111a011111111111
1011110101110101101010111111100101101111a1101111011111011111111111010101101101111111111a11110110111110112110011210102121021102120121111111111111011a111111000010
1111110111111111111110111111011111101111a1111001011111111001111111111111101111111011111a11111011111001100022121220222210022202201120102111111111110a111111111111
1111111101101110111111101100111011110111a1001110101110111110011111111111101001011111111a10111011001111001111201222212212222102112102012111101111111a111110111111
1111101111111110111111111011100111111101a1111111111111111111111011111110111111111110101a11011111101101102211112201122212110121011111212111111111011a101111110111
1011111101111011111111111110011111111111a1100010110101111010011111011101101011111101110a11111110101111111112011222011201021001022021101011101111110a111111010111
1010111011111011111111111111101111101111a0001111111111001111110101111111001111110101111a01111101111111101111101111111011111101100111111111111111100a111110110111
1111111111111111010111111111011011111111a1101111111011111111111111111111111111111111111a11111111011111010110011011111110101111011001110011100111111a111111111110
1111100111110101110111111111011110111110a1111111101101111111111110111110110110100111111a11110110011111111101011111110111111011101100011111111011110a111011111011
0111101110100111111011111110110011100111a1111111111011111011011101111010000011110011011a11011111111101111111111011111110100111111111111111110111111a111111101111
1110111101111111110111010110001110101111a1001011111011110111011111111111101011111011010a10101111111111111111101111110111001111111011111110110111101a100111100111
1111111001111111111111111111101011111111a1111011111111011111011110011111111111110101111a01111111111111111111111110001111111111111111101111111101111a101111100011
0110110000101011110001111111111111111111a1111111111011111111111111101011111101111111011a11011110011111111111111111011110011110111111111111101111111a111111010111
2112210202201120111111110111111111111110a1111001111111010111111010101111111111101101001a11011111111001100101101011101111101001111111001101111011111a111111011101
0010020221210200100111111111111111011001a1101011111110111110111111011111111011111111111a11111111110111111110111101111111110111111101011111111111111a110011101101
1221111012210120111111011111111111101101a1011011101110111101111010111011011110111011110a11111111011111111111001111011111110011101111111001111100101a011111111010
1221010112112211111010111111111001111111a0011111100110111111110011111111111011111111011a01011111111111011111011022122112221221111210010011011111101a100101111011
1210121212110221011011101111110110111111a1111010111111101111111011111110101110111111101aaaaaaaaaaaaaaaaaaaaaaaababbbbababaaabababbbabbbabbaabbaaaaaa111110011101
2222122211101122110111111111111111110111a10111011111111111111101010011110111111111110110111111111011111111111111121010221212112201002122201102101111011010101101
1122110101211210111001101111111111100111a11000110110111111111101111011111111101111011111111111111111010101100111021201210120221021211211102122111111111110101111
2101022011111121111111111001011111101100a11001100000111111111011111101111101111110111001110100011111111111111111120121022220121022110121002112111101101111110110
1201222010002212111111111110101101111111a11111111111111000111111011111111111111100111111011111111011111110011012210221021202112222100220011010111101111111111111
2221211122202222011111111111111111100111a01101011010111101101111001111010101111111111111111111110110111111110011012022122211212110212222112202111111010111110001
0221122102211122110111111010111111001111a11101111110101110110111101111111111110000111111001011111011111111111102211222220212110012212121100021111110101011111110
0222210100211201110111101111111111001011a11111111101111111011110111111110111111111011110111111110111110111111111022220221221022220222201010101111011101110111111
2021101011222211110111111111101111011111a10110011111011001111011101101101111111110000111101111111111101101111110122122112221211010122220202101101011111111111111
2212120121211120111111011111100011111011a01110011111111110001111111111111110111011110101011111111001111111011102211012220122201110121222110112111010000111111101
1202222121101120110011001110111101111111a11111111111111011111111111111111111111101111111111111111011111111010112211120100121222210121121001221111110111110101100
1222201100201110110100111111001111110111a11110110111111011111110111101111110100111111111111111110100111100111110201021020211212222122202001212111111011111111011
1110012011121201111011100101101110101011a11011101111111011111111110011111110101111111011101111111111110111111110212212201221002111220200210022011110011101111111
0220011012112211110111101111110111101111a01110101011111101110110111111111011111111111111111011011111101011101112210011201111102120211101021222100111010101111111
0222200121122021111101111110101101101111a11111000111111011111111110111101010111011010111101111111111110110111111011221200201112101122121002201111110011011111111
1201110110222021110011111111111111111111a11101111111111101011111110011111101111111111111011110110111111111111112222211121200201212221201111011100011101011101101
2201112222022211101011111111111111110111a11111101111110111101101101010011111110111011111101111101111011111111102200112212212111012000111102221011011101110100111
1102020202222210111011111110011111111111a11011111110101010010111111110111111110011011010111011110111011101111112211112100202211121100221021012111011111011011111
0112222021101111110001111111010111111111a11111111101101111111111101111111110111110111011111111111110111011111102121121010102022012020110221101101111110101011101
0002121121212020110110101110011111100111aaaaaaaaaaaaaaaaaaaaaaaaaaaaaaaaaaaaaaaaaaaaaaaaaaaaaaaaaaaaaaaaaaaaaaaaabaaaaabbbaabbaabbaabbaabbbabb111001111101111011
1121111121210221101011111111111111111101aa111110100111011110111011100101011110111101011010001110111111011011111022002211012211002001011022101b111010011100111111
2210221200110222110101011111110011111101aa110111111110111111011111111111111101111110011111111111111101101011110120212120102111210220121121121a111011111111101101
2110220211121021011010111111011111111111ab121222112112222202110012111211101111110111111100111111111011111110110112201202122111211202102010111b101111111111111111
1200100121220211111111111001111111100111ab112101120120021221021021110101100110111111111111111111111011001111011112201121121022202021220122212b111110111111011111
0100101220011011011111111110111111111110aa011111100220110011212111102210111111110111111111111111111111111111111212212112102222101012102022211b111111111111110111
0120220221221112110110101111111011111111aa121001022111010112221220020011111011111111111111111101111111111111101101101112100111222111012221112a111010101111111011
1010102222122110100111111111111111110100bb110222001102121211202120211201110011110111101101111111011110111101101110221221121121112111012121221b111111111011011011
0111101001111111001111111110111111100111ab212122221222110222211111112001010111111110111101101001010111111001101112122111100220211222012202021a200222212011101011
0111101111111111011111011011111111111000ab221121110021122111012112201221111110111100011100111111011111100111111121121112112220222220022210210a110020201201111110
0110111111111111111110000110010010111111ab210120022020102202210120020011111110101111111011110111100111100111111211220111222012112221020021022b112111122120001111
0111111111110111111111110111111011111011ba112110022212122122110221022021101111111111010110110111111111110111101110101111101102121022012201012b121101222111101111
1101011011011111100011111001111111111110ba121210212101200110220222022211111101101110111101111111111111111111011111110011111210112121112121120b222111210121110111
1010011111101101111111111111011011111111bb222111112112210111212100222111001111111111111111111011111011111111011111111110111022020122202212221b210101122201001110
1101111111111101111110000111111111111011ba222012110011012102011222021100100111110111111101101111110111110110111011111001110100221022211201100a120201222012110110
1111110111110111001011111111110111111110ba221011211222021221211120222121110111111111101110011111101111111011111000110110101021020121111121111a200022201221011011
1111111110111110111111011111110111011001bb221202100221101210222202011111111011111111111101111011100111011111010111011111111221112111001201212a211211112112101111
1101010111010001011111111111100100011111ba122111201012212010122212211210111111111101111011111100111111111111101110011111111200102111201011120b012102210110011111
1111111111111011111110111110011110101111bb121221210012212012121001211011110111011010101111111101111011110111110111111111010020021212122122210a121121211112011111
1111000111110111011101111101111111111111aa212222220012122110212000022101001101110011111111111011111111101111111011101111111110022010121200112a012012021201110110
1111111111100111111111111111111001110110ba101120011012112112212202222200101111101111111110111111111110011111101110111111111221212221222012110b211111022210111111
0111111111011110011111010111101111001111ab111121021022211200210220212221101011110111111111011100111101111110110101111111111112212021210122120b001111222121010100
1110111111111111101011011011101010101111aa011211111112221121112112211211101111111111111111111111011011011111111110101010111120122121112220120a022100110212111100
1111111101110001111111110111110100110111bb221022221122111222200212222020110111111111111011111111110110111111011111011111100121211200202212122a121201210111110010
0110111011111110111100111110011110011111ba210201120022212022022122101111000110111011101111100101111111110111111111111110110122111222022122221b211111211221111110
1101111011111101111111111111101111111111aa212121102222112111200121011111111111110111011101111111011001011011001111011010100111101111102020101a212211212222111111
1111111111111110111101110111100011011010bb111112211111212100101211102111111010111111111111011111110111111110111011100111111022010222121222002a110111222121101111
0011110111111010111111111001011100111111ab221112222210011200212122202121101111111111111100001101101110111111011011111111011101111002122021111b101222111021110111
1111111001111101110111011111011111101111ab022112111102112110210100211221111111111110111111011111111100111111011111111111111122201100200212111b112221201001111101
0011111101011111110110111111111111111111ab222112022211222121221001212211111111101111101110111011111111111111110111101111011000110211220120202a112112021212011111
1111111101111111111011110111111011110110aa221012121111022222112212021201111101111010011100011111011111111001101101101011111112202121101210002a110222202122110011
1111011101011011011111111010100011100111ab101120121112021110111012211221011111111110011111011110111111111111110110110101111022222122221221011b122101202112101111
1111110101101111111011111110101101111111bb122122211112111201202201222011011101111110011111111111011011111111111110111101111002220222211112210a121221020021111011
0111010100111111111111111011101111111011ba222212022110122022001111212200111111111111111110111111110111111011010111111101101021221021000020111b121121121022111111
1111111111111111101110111101010111011101aa111111111101111011111111110111100111111111001111111111101111110111110100111110011111202221111222212b211011222212111010
0011110111111101111110101111110111110111aa011111111111111111011110011111111011101111110111111111011111110101111111101111101122221121202021112b122202222010111111
1011111111110111110100111111011111111110aa111111011111111110111111111110111101111010111001011011111111011101110111111111101010202100220211221b120011210111111101
1011111101111000111010110111110111101111aa111111011111111011101110111111111111101101111101011111111111111111101111110111111211111221120200222a121212212221111101
1111011111110011111110011111111101101111aa111010111100111111111111101111010010111111111111110101101110111011111111101101011020112022211211221b221211212001111111
0110111110111111111111111111011110111110aa111110011111101111111111111111111110011110011011111111101111111111011110111111011111101011101110011a111111111110111111
1110111101111110101111110111111111111101aa110110011111101101111111111011011110111111101111111111111010111110111101011111100111111111110011111a111111111111101111