2 66
156 83
117 90
111 24
35 44
78 30
126 104
34 96
106 84
70 12
10101111a1111111111010100010111011111111011111a10101001202120121021021100122220201111200a111111101111111100111010111010a1001111001110111011111010111111110111111
11111111a1111110111101110111001101100011111011a11111101211121210021111120202110111211011a111110011111011101111111101110a1111111011100111110010110100101111111110
10011111a1011010011111111111001110101111011111a01011111121210111221121012022222110212210a111111101110011101111111111111a1111010100101111011110111111111111101111
11111111a1101111111110110111011111110101101100a11101111021021100122022122222210112210210a111101000111110111110010111011a1111010110101111111001111111111111001101
11111111a0111101111100110111111111011111111100a11111111202001201121201021002112011202011a110100111100110110101111111111a0111111111111111011111011110111101110111
11011111a1111101111101011110111010111011111111a11010001121111222121110122012121202120211a101101110011001111101111110111a0111110111001100111111010111011111110010
10110111a0111111111111011111001010101111111111a10110111022120021212221100111110112112101a111100101101111011101111110101a1111111101111111111111110110101010111111
11111111a1111111111011111111111101111011110111a10011111011222211211221001111020121101211a111010111001111011001111111001a0011111110101011011111101111111111101010
11111011a1011111111111111111111011111110111101a11011011111012121121211021022011212122210a111111111110111111111111111111a1111101111011111111110111011111010110111
11101111a1010111011110111110111111011111011111a01111011112022211120102222211211111110011a100111112210111211120211111111a2220211111110111011101011011011111111111
11111101a1111111101111111101011111101100110011a00110111121012112220121121011220122211211a111111112210122110122110120010b1210222111011101011000001110111111110111
01110110a1111011111011111110101101101110011110a11111111012111001122121212212122002110211a110101111211010202121112121212a2111122111111111011111011111111101111101
01111001a0111111101110111110111111111111111111a11111111201122022021221210201111221202111a011111122220122102212101110112b1222110111101110101011011111111010111111
11111010a1011011011011110101111111111111111111a10111111212202212222211212111010200210211a111111122112211121112002201121b2020021111100111011101100111111111010101
01111011a1111111111101100111101111111111110111a11110110211112221202222222012222201120201a101111111211122221202210120102a1222010101111111110101111111111011111111
11100101a1110111110101111111111111111111101011a11111111201112112222012022222202021200212a211221011212121111221122010121a2121121001111111111101111111101111001111
11101111a1111101111001111101011011101101101111a11111110012212222222122102202210221222221b210111121200112021000022111222a1110220110111111110010111101100111111111
11111111a1100011111111011111111011111101111110a11111011102221220222201222202011210012212a121111110100212211222001211211b2111221011110110101111111111110100111001
01101110a1011110111111101111111101111101110101a10100100212122222222221222222002211122222b220210111111101021222111210021a1021112001110011101111111101110111111110
11011111a1110111100111111111111111111111101111a11111001110221002122021122212211222222211b211011101222111121121022021112a1112121110111111111101110111101111111111
10111011a1111101111011111111011011110111111101a11111111021121222222122222222202121222110a010110120020211220221002100221a2122221111101011111010101111011110100011
11110101a1100110111010111101011111111011111110a11101111201202220220112121222120222102221b222200111111021122201102121221b0122001011111101111110011111101101111110
11011111a1100111111110111101111111010111000111a11111111110222012212022222012210212212122b110121021222111011112221011121b2212102110111111111101011111111111101111
11110101a1111110011111101110110111011111111101a11101111121212221222210221202122222222212b220011111112221220112201101221a2120112111010101110000111111111001110110
01111111a0101110110111111110111111111101111101a11111111122021122222222122222220122222022b120201001211111222110201010122a1211110111111011111111011100111101111011
11001111a1111111111111111111001111111111111001a01001111001112120222212002222102222002021a212111021222221111000120112022b0112210111111110111111101011101111101111
01111110a0111111110101111111101011111111111011a01110111002121122200021221202210222101101a221111112011202211121201121021b2112222110101001011111111111111011111110
11111011a1011110010100010111111111011110111111a11010111102122022222220212221120222212022a100111022222111011010222000022a1220121111111101010110001111011111111110
11111111a1111111111110111101111110011111000110a10010111101111110221112212102201111222011a201220120122122110222120022212bbbbaaabaaaaaaaaaaaaaaaaaaaaaaaaaaaaaaaaa
11111111a1111110011112110220221121210212222202b22211011101111111211211022121102011120212b1012211112200211112222121122222222200201111111111111110011011111110111a
00111101a1111111101121101022211222111122212111b22211110100111111120112200121102212012120a2021211212102020110112011022121121211111111010111111010110100111111111a
10111010a1111111111110111100101112022021212221b12121011111111011122112112112121212002221a2021111121001120102221022101102221222201111111101111000111111110111111a
11111001a1111101111102011211121202111201112012b22101101111111111212202112101201021111120b1202011001111120122011221112101012112211111111111111110111111111001101a
00111101a1011110111120121101222122222222002122a20221111111111111211100101122121121111100a2121211201211221210112212210112011021210110101111110011111101111111111a
11110111a1111111011122122122222212211111122211b12121101111011102210100221122112121101111b1222211220121212011110120112211201012211011001011100101001111111011111a
11111111a1101110111022120210012110112222211210b20021110111111112011011022202102211212011a1211101202010022221012101120221021110211111111110101111111011111111111a
11101011a1111111101111212112122011120211002112a12221011111111112210011121212021122121200a1221210021100201121211202220212201121201111101111101011011111111111010a
11011010a1111110111111221112222112212020211112a02011110011101112111020212121110112100112b2112211010011010101001022121210102110001111111101111011111111111011111a
11111111a1011101011020012002022111012101012211b11211011010110110110222021101100121121020b1212201212222120211222221000220102222211111111110111110110111111111111a
10111011a1001111011121210202122111121221121221a11221111111101110122121121120122221122111b2112111111120212210012022121220221112211100111001100011111111101110110a
00111111a1110110111111021221121211020001212101b10011101111111002011122112021110211212112a2011011101111011011010101111111111111001001111111111111111111111111111a
11111101a0111111011121122112121022221122222111b21000111111000112222101212120221100220101a1121211111111111111101110111011111111101111111111110010111101111111110a
01111010a1010110110120102210122220221111112021a21211111111111011212122121112212101001122a1120211100001011110111101110111110100101111111101110011111110110111111a
11111111a1111111110010100221210202120222220112a12121111011010112021101202010022120220220a1222201111011111110111110111111111011101110111111111100111101111111111a
11111000a1101110111022220122101212112201221212a12111111011001012010122111110212122222112b2111201101111111101101111101111011110100111111111111111111111111111111a
10111111a1111111111102001222001110222122121210a10221110111111112200212100212110112211201a0022001111111111110111110100111111101011111111111110110011110111011110a
11011011a1100111111022222201211122210102222220a11210110111011111111101001111101111111011a1011111111111111111110111111110111111110111101110111111110111111110111a
11111111a0111110111012210011221022222111121111a22220111111011111111111101001101111111101a1101000110011111111111111111101111111011110111011111110010111111011111a
11101111a0111111111111022121221111110020221220b10201101111111110111111111111101101101101a1011111111111011011000111111101111101111010111110111101111110011111101a
11100111a1111111101100102021222200212122010110a11121111111111111011111111110110111111011a1111111111100110110010101110111111101111111111111011011111011111110111a
11111111a1011111111010120211012021200212012221b21211011101111111100010111111111111111111a1101010111011110111111111111111101101111000111111111111111111011011010a
11111110a1111011111112112011121112122222010121b22121111101110101100011111111111110111000a1111111011101111111111111111101011111111111111011011111101011111111101a
11101111a1111111111112012112011200011112220222a01221111110111111011101011110111101011110a1111111110111111110111011011101111111111111000111101111101111111011111a
11101101a1111111110100112100022212111012022211a12121111111111111111101111100111111001111a1011101101100111111111111111111100111111111111110110111111111011111111a
11111100a1101111110122202012022221112111221222a11220101101111111101111111111111111111111a1100100011011111111111110001001101111111011010010101111101111110111011a
01111011a1101111101122221011011112222210022212b12211111011111111011111111111101111111110a1111001111111111011101111111111111100111101111111101101101111011111010a
11110101a0111111111121121122211022211021121201a11021111110111111111111111111011111111111a1110101110110111111110111011111001001011111110111111100111011011101111a
11011110a1111111111100222221210111211002122101a21011111111111011111111111100111011111111a1111011011111111111101111101110111101111111111111110001111011111111101a
10111010a0111111010121102121112112201020122221a12210011101111111110000111111111111011111a1011111111111111011111100111110111111110011110110111110001110111111111a
11011111a0111111111112201111221122122120111111b20221111111110111111111101101011011011111a1001111101111111101011010111111011110110111001111100111000001111111111a
11111111a1111111111111011110000111111111011011a11111111111011111111111110110101111110111a1011101010000111001110101111110111111111111101101111111111111101111101a
11111111a1101011001010101111101111111001011101a01111101100110111111111011110111111111101a1101101111111111011111111111100110111011101111011110111111111111111111a
01111111a1101111011101111011011111111111001111a01110011101011101111111101011101110111110a1111111111110111111111111111111111101101111111110111101111111111111011a
11111101a1011111111111111011111111111111111011a01100111111111101101111111011101111111111a1111111110111011111111111101110110111111011111100110011110111111011011a
10111111a0111111101111111010011100000011111110a11111011110111110100111001011010101111011a1111111111111111111100111111101111111110110110111111111111111111111111a
11110111a1011111110111110110011110111110111101a11111111111111111011101111100101101111100a0111111101101101111111111111111111111111101010111111110111111101111111a
10111110a0111110101111100111111110110111011111a11111111110111111111011011111101111111110a1111111011110010111011110111011111111111101110111111111111110011100011a
01011110a1111011011111110110111010001111111111a11101111101111011110111111101011101011011a1111111111011101111100111110101101111011110111111111111111111101111111a
01111111a1011011101010111101111111111111101111a00111010111011101111111011011001111111111a1101101111001111111011111101001111111011111111110101110111010111110111a
01111111a1111111011011111111111101111111111110a00110110101111111011111110001101111110111a1112222021111012201010111211202011111111111111111101111111011001001111a
11111111a1111000011011101111101100110111111111a10111111111111111111110111111111111110110a1111021022021101022111022122201111111101111101110101101111101011111111a
11101111a1111011101111111111011001111111001111a10010111011110111111011110010111111111101a1102221221221221222012111022012110111111111111111111111110111111101111a
11111011a1111111110111110100111110010111101001a01111101011111111011101011111111111000101a1110212212112211211111212111122101010110101111111101001111111110111111a
01111101a1100111111111010110101011111110011001a11110101111111100110111111111111010111111a1112120212221211112202211111112101111100110110111111111010111111111111a
11111101a1101011110101111100111111010101101110a11011111111111110111010111111111010000111a1112221211100200121001112201112110111111111001111011111101011110111111a
11011111a1111111011110111110011111111111110011a11110101110101101111111111110001111111101a1112122112112102222222120222121022011222112211111111101101110111110101a
01111110a1111111101111111111110111111111110011a11111110100111101011111111000100101011010a1122220221210222112010221212220122211121222010111111010110001111111101a
11001111a1111101101111111011011111001000111111a01111001011110111110111110010111111111011a1110111211022102222200022210222222101122010111110101111111111111101111a
10111111a1111011111111101111111111111111111111a11111001011111010111111111111111111111100a1122022110011212222221202202222201020110022111111101110010111111101111a
11111101a1101110111101110111111111111111110111a11110111011011010111011111110110011011111a0122122111212122222211222202222222102012102211110111101011111111010111a
10101111a1011011111011100011111110111110111011a00110101110111010111111111111110111111000a0112221220122222222022222122200222220021211011111111101111001011111101a
10110111a0111010111201212221022212122220122211b10000111011110111010111110110111111111010a1021222212021221211220202002221122121212200111111111111111111111111011a
11011111a1111111110021201101122121020220112221b22211011011100100111111111111110011110011a1122110221011211122212212221202022212222111211111111111111110111110111a
11111111a0111111110221121022122212100111211200b21211111110111111111011011111111111111110a1102122120112220202222121222222021222112211101111111111111111101111111a
11111011a0111111111211022110121112210011211202b21211011101111011010111011111101010111010a1110012221212122202202122022212102221201110201111111110011101101110110a
11011110a0111011110121211222221222222221121121a12111111111110110111111111011101101111110a1121221112112212102121222022212002011021012011101110111100110111111101a
01111101a1111111111220220111022121221022111211b21100110101110110111111111111101110101100a1102212221211221110122120020211221211222122110001101110100111111110110a
11111111a1011111101122212010112211100112221202a22011111101010111101100110111011101110111a1012020101110222222222112222020102120022221210111111111111111111111111a
11111111a1111001111222221212112021122212121212a01110111011111111111110011111010110111111a1012121112222122021222022121210022120202102211111111111011110011111111a
00111111a0110111111121211121111122212000011022a10110100111011101101110111111111110111101a0011212121201222202221222220202221112122221221112112101111101110111101a
11010111a1111101111220010222021222111121211100a10011111001111111101011011111111111111111a1111221211220221221222222222020122220011201101002222111111111111111111a
11111111a1111111111201101020012001222101220200a11211110001110111111011111111001111111111a0121222120212221222200021212202022211220222011002111211111111111111111a
11111111a1111111111222221212122111200222211001b21101111110110010111001111111111101011111a1122211220210111122100222202222212222222221221222111111111111110111101a
00111111a1110010111012221002122010110112120110a02111111001111011010111010111101011111000a1102021210201210220210222220220222212222222012222212211011111111111111a
11111111a1110111111111222012122211121121121120a21211010111111111011111111111010011110100a1122101020221122212202222020222221202002222212010210010111001111111010a
11111101a1010111101122112100200102211221110211b10111011011111100111111111111111111001111a1021212110021222212122212222022222120212200222012022011111111111011111a
11101100a0111111110001022110111221222110112110a12110001111111111110111111111010101010111a1022100220211212022122122220222120220222120211211111211111010111110000a
11111100a1101111111012112211012212121221021112a11200110111101011011111011110101101111100a0122112222111122212101222212201122220102220221221101111111111110111001a
10111111a1111110011221221212011221112222121001a01211111011101111111111111111111111101001a1112121212110012222021222002222222212010222211202101201101111110111011a
11111110a1101111101012221120011211221002221020bbabaaaaaaaaaaaaaaaaa100101101101110111111a1110211111220221122222222222211202222122221201002211211100111110111111a
10101101a111111111122211111220222211011102221102010111111111111110a010111110111110110110a1111110111111201222202202002222022100021200010122110211111010010111010a
01111111a110111111100121012021211112212201121121211111110111111111a101111011011111111101a1110101111110122122110112120202212020202222022120012011111111111011111a
11111011a111111101110102120011120122000222112221221111011111111011a011111000101011101101a1111111110110010010111002222202222101222222210102111110011110101111111a
11111101a111111011100110220221222221101102221101211111101110101111a111111011111111111111a0101111111111211102012220212222002020222102211210222001110111101001111a
11111111a101110110122112002212210011122221010102221111110111111010a111110010111111111101a1011011110101110021021202022122211022222222112101122111111111011111111a
11111111a110111101122101210222222121202102112122011011111101111011a111111111101111001011a1111111101111111101121022222121122102222022211121022211111111111110111a
10001110a111111110111221002021021022022221200112001111010010111110a111111110111101111111a1110011100110111100011222220211122111111120112212211111110001101111101a
11001111a110110101120021210122222021121111221211021111110111111100a111111011111101001010a1010111010111101011111020111220210221222021202202112210111001111111110a
10111110a011111111122222211120222000011121121211111111110011111110a101111101101111011110a1101011111101111111111002122111222121121201112221101011111111101110111a
11011111a110101110111212111102112112122211222220201011001111111101a100111111111110111111a11111110011111111001111222101101002222111220120012211111001110111111001
11111111a110111001120101120221201121201000212120211111110001011111a101111111010111110111a01111111101110111100011221220112022202102002200011021011011111101111101
11110111a111111111102200121212210100022212220211001111011110001111a111111101011011101111a11110111110110111011112122212111021210221122212220110011101011001011101
11101111a011101001001111110110011101111110110110101101001011111111a110111110111111111111a11011101111111111111011002222012201211111222022121201111111011110111111
11011010a111011111011011111111110111111111011011111111101101011111a110111110001111111111a11100101101111111100101112201211122211021221212211121101111101111111011
11110111a111111111111110111111111110110111011101111011110111101111a111111111111111111011a11111101111101111111012010211111021112121112211010002101111101001101111
11110111a110010111111111111011111011111011111111011111011111101111a110011011111111111111a10111001111101101011101111122211120122111211221122001110111111111111111
11111111a111111111110011111111100101111100110111011111100011110110a111111101110111101111a00110111111110110111112111121112012011211111221121021111101111111011110
11110011a010111111111011111011111111111110111101111110011111011111a111111111010111011110a11111111111110111101111102112110122001221211212221122010111001111111111
01110111a101010111111110111111111111111101111111111101111100111111a110111001011111111011a11111110111101111011112201021121002012120202222211211101101110111111001
11111111a101111011111011011111101011110111110111111111101010111111a011111011101111111001a11110111110111111111001121220110220102112112102120212011101101000111001