85 9
81 113
11 106
104 77
140 110
21 32
77 47
66 74
84 61
111 114
10001001a1111011111111011011a1110011110110111111101111a011111001001110010100111011111111011111000111011001111011111011111101110111011111111101111111011111000111
01111111a1111011111111110111a1011000111101011110111111a111110111111111110110111101111011111111101111010111010100110111110111111101110111111001111111111111111111
11101111a0101111111111111101a1111011111111101111111111a101111100111100111111110100100111111011111111011111111011011110111110000110111101111101110100011111011111
11111111a1111010111110110110a1111111111111111111010111a111111111011111111111011111111111110111111111010111011111111111111111111111111111100011111111011111111111
01011111a1111111001010011101a1111011111101111011101111a111111111100111110111111011110111111111111001111100110111111111111101111111111111101110111111111111011010
11111111a1111110111111101110a1101111101011111101111111a111100101111001101111111110111100111111111111111111110101111111111111111111111111110011111111110111111010
11010111a0110000111011111111a1111111111111111111011001a111111101111111111111111110111110111001111111111011101111111110110111011100101111110101111111111110110111
11101011a1101001101110101111a1111111111011111111111111a01111111011101101110110111101111101111111111101111001111111101111011111111110110111111111110010111111111a
11110111a1110110011111101110a1111110111111111111111010a11001100110010010111101110111111101111011101010111110101010111110111101111111111111111011111111110111111a
11101111a1111101110111111111a1111001101011101011111011a10111011110111110011111111101111111111111101101100111110111111111110000101111111011111001111111101111111a
11111111a1100110011111110101a1101111110111001111111111a11110001111110011111110111110111111101111011111110111111111110111110010110011111101111111101111111110011a
11101111a1100111111011110101a0111011111110111111110111a11111010111111111111011111110011111111110111111111101011111001110011110111101111111111011111110111111101a
11110111a1101011011111111111a0111011111011111111010100a11111111111111111110011111101011111101101101001011001011110101101011111110111111111111011011111111101111a
11111111a1111111111111111110a1101111111111111011111101a10111111111111011110111110111101111111110111011001111111011111101001101011111111101111111111101011011001a
11110111a1110101110111111111a1111110110111011011110111a11110111111111111011111111111111011101110111110111010101101111110011111011110111111111010110111101111111a
11011011a1111111011111111101a1011111100111111111101011a01011010101111111111101011111001111111111100101101011100111111111011111110111011111111111011111011111111a
10111011a1011111111111111101a1111101101110101111111110a11011111111111111111010111111011111110110111111110111111111101111111111011110011110111110111111110011111a
11101112a0121200121112122211a0010222111111111110001111a11111111111111101110111010111111111111011011011111111011011111101111100111111111110011001100101011110110a
10011112a1122222110112102100a1002121111111111111101110a11110010110101110111111010111111010111111110111111111111111111101111111111111111101111011100101111111111a
11010111b2111011122011100112b2022111211110110111111111a11011011111110111111111111111111111111111111101011001010011111110101110111101110111101101111110111111001a
10111122a1222122211202121012b1022102011101111101111011a11011111111110110110111101111111111111111110111010111110011110111111111001111111010111011110110111111111a
11111121b1122110112111122211a1122121210111100111011111a11111110111000111011011101111111111111110011111111110111100111111101111011111111111111110110101111110111a
11101121b2221211210121211102a1011121211101101001111111a10101001111111111100111011111111011111111110111111011111111111111111010111001110001111111101110111111101a
11111022a2222111101101111122a1112220011110011101101101a11111111101111111111011110011110111111001111111111111110110111111111110111011101111111111111110101011111a
01011120b2210211202222112111b2211111111111111111011110a11111101110111111110011111111111111110100111111111111111111110101111111111110111111101011111111111101111a
11001111a0111000220200002210a1121000211110111111111101a11110101111111001111111010111111111111111111011010110110001010111011011101111011111111111010110111111010a
11100112a0021212222121121220a1121110011010111111101011a10111111111111111100101111111110111111111111011111111111110001110111111111001111111100111111111111111011a
10111010a0212122201222111220b0011112201111111111010111a00111101011011111111110101111011111111101111101011111111111111101101111101110111011100111101101010101111a
11111112a2112121111212101121a2210222011111111110011111a11101101111011111111111110111011110010011011111011011111101110110011110111110111010111011111111110111111a
11111121b0221020200201121222b0222120111111101111111110a11011011111110111111011111111111111111111111101111110111111111111111101111110111101110110111111111011111a
11111022a2221202010121101122b1111121111111111111111011a01111011110111011111111011111111111110111110101111110011010111111111100110011101110011101111111110111101a
11110101b0021022222210012102b1222010111111111111111011a11101111111111101011011111111100011101110111111111111110111111111111101111111110111011111111101010111111a
11110112b1222022212220102102b2221211211011111101111010a11111112110220201201022201110120222101110111111010111111011111111100110111110110111111111111111111111111a
01110120b1110001111201211112a1210201111111011111111111a11110111221222212211111111120112122222101111110111111111111111111111111011111111011111110011110111101001a
11111101a2120102012220021211b2210111011111111110101011a11111011212211220202122122122201122221111101111011111111110011011111111101111111111111111111011111111111a
11110110b1222212001122010212b1110110011110101111111101a01101112112021212202221002012211110020101111111111111111111110101111011110011111111111111110111110110011a
11101111a2122122211222101112a1222010111100111011011011a10111102001022020011212202210210000121111001111111110011101110111100111101111111011101111111101111011111a
10111100b2112202220220222220b1220110210101110111111011a11111110110101102121010012021210111112110111101111110110100011110111011100101011010110111111011011111111a
01110121b1111022112111020012b2212022211111111111111100a10111112221211101211221210101221021221101110111111011001111110111111111101101111111111011111111111110111a
11111112b2112122000221202201b0022122210111011111010011a11111101002111101112122102111120122221111101111011111110111110111111101100111101011010111111111111111111a
00011111a1010211211221212111a0201222111110111111011000a11101011201012211210121001121010021111111111111001010111110111110110101111011011011011111111110111100111a
01111112b2211122122112111222a1021010211111111111111111a01111112122212120022212002021111110012110111111101001101111011101101111011011111111111011111111111101110a
11111110b2102011002121110111a0121212211111111111111100a11110112011101220112122112212210122110111011111111111011100111110111101111110110111111111011111011111111a
11111011b2202022200221210120b0111011101111110011111011a01101112122110212112111011011111212111011111111111111110011111111011111001100111101111001111111011111111a
01110122b1221122121222121120a0112210211010111111101111a11110001112221001112201122212010121102111011101101111111111111011111111111101111011111111010111111111111a
11111012a1210021121220121021b2122111210111101110111111a11111112022021212021122212101022112202011011111001111011100111101111010001111110111111111110111111011111a
01111102b1020221200122101221a2122210210101011101101101a11111101011222222220120122212212121022120221201101110111011111111001111011010111111101111111111111010110a
11111110b2122211101101011001a0102222111111111110011110a11111002102022012002222020202120022221221211211111011111111111111101111111110010111100111111111001011111a
01111101a1111111111111110011a1111011001111010101111001a11111112202020222120200212112211002020021220211111111111111101110101110111110111111111110100111111111011a
11101111a0011111111011110111a1010111101001111101111111a11111111201200222212212222221121222111221211111101111001111111001011111101101111111101110010011110110011a
11100110a0001111111111011111a1111111111101111110011111a11111110001101112120222212022121202122111210111111111011111100111011111011101111111111101111111101111111a
11111111a1111111111001110111a1111111111111111110110111a01110112102112211222222220220222022222121000101111111110011111101111000101011101111011111111111111111111a
01101111a0111110110111111111a1001111111111100111011111a01111010021112122121110002212221220222211110111111011110111100111111011111110011100101111111110111011111a
01101110a1110110101111111111a1011111111111011010001111a11110112101112021211002021112220222222212112111111011011110011110111110111110011111111111111100011111110a
11111111a1111111111011111011a1111111111111001110111001a11111111010122202221220212220221122102211120211111111110111101111111111110111111101110011101011111110101a
11101110a1100111110100011101a1111010110110101101101101a11111112110111222120122212221102110211211212010111111101101111110111010111110011111110111111110001101111a
11110011a1101110110010101111a0111111111111110110111001a11110012212211222212022222020222000002021112111010101110111111110101011111111011111110101111111101101111a
01111010a1111111101111011011a0111111110101111111001111a11011111000121122222222122122222222020201212011111011001011011111111101111111111110111011110111111101101a
11111001a1001011111111101101a1101011111110111011111110a11111110121101222122002101201222221221212020001011111111101011100111111011111111001101111111111111111110a
11001111a1101011101111111111a0111101111111101111011222a22001202002212222202212221212020222122212111001110111010111111101111101010110011110011111111110101111110a
10110111a1111111011011101101a1101111101101110111011021a11110110222122220201220222220221202222102100010010111101111011101111011110110111011111111011111111011111a
01111111a1111111111111110111a1011011110111011111111020a20110022122222222222220022012122021022222010111111111111101101110111111011010110111111111101101101111111a
11111101a1111101011111111101a1111101101001101001111111b22212000202022222222220222220221222220002222212201111111122202222011101011001111010111011001111001101110a
11111110a0111111100111111111a1101111111011111011111022b10212010012201221022202222221202111210122221221212112200001102221001110001111111110111011111111100110111a
11110111a0111111111101111011a1110111111101011011111101a02121202221101212221221222212122110121022122002211211211002112011111111101111111111010111111100111111001a
11111110a1111101111110111111a1111111101111001111111221a21011021221222222212211221211212122122202222211000211122202122211011100111110111011111111111000111110110a
01110011a1111111101001111110a1101011111111111110111221a01022000011212001022220200222101002102222222222110110120211012222110111011111111111111101110111111111110a
11111111a1010110111111011110a1111101101011111110001110b12121211000112022202212221200222000202221212011211012101112222212111011010111111010111100111100001111111a
11111011a1111111111111101111a1111111101111111011111012b12112201010112220222222122201102212222022112122102020222011122010111110110111111110111101111011111111111a
11111101a1111011111111101101a1100111110111011100111211a12212221112220211220222222211121212110220122100011122221200211210110111101111111111110111010111101011011a
11101011a0111111111111111110a0111111110111111010111210a02110121222120120211002120101112011021222222221121210121120100221111111111110011011111111111011111111101a
11111010a0111001111011111111a1111111011111111111111112b10221122122010022221222200212200222220222122001021210000211102122101111111110110111101011111111111111001a
11011111a1111111001010101110a1001111111111111111110022a02210111211002010222022012202101222122220222211222221112002121212111011011111111111111111101101010000101a
11111011a1111011111111111110a1111111110110001111110221b11011021220211020212220001211021122211122011111220121202221220212100111011111100111011010110111011111101a
10110111a1110111111111111111a1011111101111011101110211b22220102101202010201002220222220210221211101112221011121121220211111010111111101010101111111110111111110a
11111111a1111110111010110010a1111111101001011011101202b11010100121011112020202020021121222222221022121210122012010101121100111111101110110110110011011111111111a
10111110a1111011010011111011a1110110011111111111111222a11122110012101022222202122211220212120102222220122200222212122112111111111111011111111101011011110101111a
11111111a1101011101111100110a1010111111101111111111012b01212120221001121210202212210100101211221121221012122022120121120100101111110111101011111111111110111011a
10111111a1111111001111010111a1111101001111111111111112b20011211210222220222112020110111101210112022110112222211202122010110111111110111111011111111111110011111a
01111111a1111111111111111110a1011111111001111111111201a012000002011020222121122100111011111212102111211211211100210022120111010101011111aaaaaaaaaaaaaaaaaaaaa10a
11111110aaaaaaaaaaaaaaaaaaaaa1101111111111111110111122a102102012022112220110112222111010022112110212211210212202112212221111111101110101a1111110011111011111a11a
111111011011111011110111111111100111101110101111101022a120122201101111121120221122111111112211012210112121112201121012211111111011111111a0111111110111110100a11a
111011111111111100111111000111111111011111101110111022a220202220112111212121201211111110001221121110111102122022212012011111101110011111a1111111111111111111a11a
111110111100110111001101111101111111111110111111111221a201212001202111110022112221111111102022201211011221011202201022201111111111111101a1111011101111110111a11a
111111111111011111111011011110101111010011111111101111a202202110222122102221221111001111102112011022122121112111112012201011011111111110a1111011111111111111a11a
101111011000111111111111011110101010111101111111111021b220111012121100211110211222111101121022211001212201210111101201011111110111111111a1111101111111111100a11a
100011111111111111110111111111111110100111111111101111b000100221211210202222021211111111022210121111010011112101022122011110111111110101a0101010111111111111a10a
111111111111111111111111111110110111111111111011111220a221112202121100121121211210111111120211221121211101022122212102121110111111111111a1111111111111111101a11a
111110111011110101111111111110001111110111111110101122b110120112201221222212222101111010110121012122111111111012021011221011111101101111a1111001111011011111a11a
110011111001101011111111111111111111010011110011111021b022222110211202122211012200001101121101212222210210102121212112111111111011111011a1111111111111110111a11a
001101011111101111111101111111110111111111010111111001a111110110001110111111111110011111111112122212221112212111221200111111110101111111a1011110111111110110a11a
020111122020110212120112201111111101010111111111111110a111101011111111101110011111111011112112001221212101120201212101101110001111111010a0101111111111111011a11a
222222121022002220012021120111111101011110110011111111a110111101111110111111010111101101000122122212220200012021021121011101111110111111a1111111111011111101a11a
111211210210022201101102111111101111111111110101111110a111011111110111111111100111110101011001111111111111101111101101111011111111110111a1110110110101111110a11a
012002111210121211122220112011111101111000111101111111a111101101011100111111111001111111111111111111111011101111001111010101100101111111a1111111110111111111a10a
002122120221221222201201120111011111101110111111100111a011100111111111110111111111111111111111111111111011111110011111101011102210222121b0121002221100121012a11a
121121222212101121221222211111111111011110111111000111a111111111111111110110011011101111111111111111111011111111101101011111101020101122a1121112202100011222a11a
021022210212122000121211210100110111110111110101110111a111101010010111111111011111111111111111111110111101111101100010101110101221022121b0002122112221222221a11a
111112212122221112012221112111111111111110111001110110a111001111110001111111111111111111111010111111101010111111111111111111112212212111b1020220221122221110a11a
012122012201101211101101022101011111101111100011111111a101001111111111111111111101010111111110011222220211112022211121021112112120210121b0101212121221121010a11a
221221221120221111110120200111011001111011111011110101a111111111111100111111111110111111101111012220112002211000110200002112021121121021b1122200110021112121a10a
211011110201112101210222212111010111100111110111111111a111111110111111111001011111111111011111110022112112220212212111012121121121110211a0211102101111212211a11a
111011022021011201020211220111100111111111111110111111a111001111111110101100101111111101010100112121122022211212022010111221212020000112b0001021221220111122a11a
212220001020211201211111212011111111110011111111111110a111111001011111111111111101111101101111012221021121212012102020122121201222211211a1221201201111120210a10a
010110021112212120102122202101111101110111110111001101a011110111111111111011111001111111011110110121201122012221222200021022222021211211b1211221222122021220a11a
121221112112202221102112112011011111110110010111001111a011111111111101111111101111111110111110111212222222110221022221021221002220022211b1222221102011122100a11a
021211110121022112212211111111101101101101111111111111a100101111111111110111111110111100111111111220011212210222210111012200200121221122a2211212221212011211a01a
121202201112202221211212022111111101101110111011011111a110111101011011111111110101110111011111010112120221112221112121110001220112121110b2212010011120120011a11a
201201021121222211221001102111101110111111111111110011a101111101111111111111111111101111110101112212120112122111212221121200122000121222a0102011122112222002a111
210202122122211202111110000101111111111111111101001111a110001011101111111001101111111111110111111110121211221220110121211222022101220222b1212111211102221220a111
220221110220121102220111120011111101111111111100011100a110111111110111011010111111011101111111100122221211222201221221220011022212221110a1201101221122100121a101
222010222110100121221121021110101110111101111110111101a110111111111100111111111111111111111110111110112200110002222120101112122212102122b2201102201201112012a110
121212222021221021110211222101011111011001111111110111a111111111110101111010010110000111111111111221111122011202001221202112222012221110a2200220000111001021a111
111212122100112220212120212111010001110111110011111110a111111111111011111111111101111111111110110012210221221222120222102122122111122021b1012111111221210121a111
210112011112222012102012010110011111100111111110111011a101111111111111100111001111101111111111002211121000012222222112111210112221111111b0122011221021210121a010
111122211122101000201122111011001101110111100111111100a111111110011111111010111110111011101110101211122111102220212020100222122120220022b1112102211201111211a101
202221122022222211112112121011111111110111101111111111a111110110011111101011111111101110100011111222221101110202201111201102222120202211b2121101212221011221a111
222111110111211102120101221110111101110111010111111110a111101111111101111101110011111111111101112210112211012222211022111200122101022011b2202012122201221100a111
122122121222122111211211000111111111101011111111111111a111101111111101111101111011111011111111111021012001212201222221212002100101210221a0212122111221122122a111
112122121121111012002021210011111011111111111101101111a111110111101111101111111111101101101111111222101000211120211112111112121210211010a2101111220201122111a111