83 17
68 118
141 57
150 49
147 71
115 100
82 71
42 116
131 70
117 44
011110111111101110a1110101101111111111111110111a011010110101a111011101111101111110111101111111111111010011111111101111111111111101111010110111110111101111111011
110011111111110011a0101110111010111111110111111a111111011111a110111100111111110110111011111111111111110111111111111001011111111111111011101100010011101111110111
111101111011111011a1111011111111101101111101111a011111100011a111101111011111111111111110101111101111111011111000111011011100111110011111001111101000111111111111
111111110111110111a1111111111001111111111111011a111001011111a111111110001011111010100111011111110110111011011010101110111110101011010101111101111011111001011101
110111111111101111a1111111111111111011111111100a111111011111a111010111111011101100011111011111010111110111111111111111001101010101110111111110111111111100100101
011101111111111111a0101111111101110101111000111a111110111111a111110100111110111111111101111111010011111111110011111011011111110000111011111101111111100111111111
111111101110101111a1001101111101111111111010111a111011111111a111101011011111111011101101101111111110011101011111100100010001011011001111111111101011111011101110
111110111111101011a1111011101111101111111001111a011111101110a011100001111111111111111101110111111111111111111111111111110110111010010011101110111111111100111011
111111110111110111a1111111111111101100111111110a111111110110a111011111011111111111111111111011110011111111111111111100110100111101111111110111010011011111001110
101111110111111101a1011111111101111010001001011a110111111111a011100111111111101111010111110010111111100100011101111111111100000111110101111110111010100110011111
111101110001101110a0111111010110011111010111011a101111111011a111111101010110110111101110110111111111111111100101111011111001111111111101111110111111111111111001
110111111111001111a1111101111111111111111111101a111111101111a111110011110111111011111101111111011111111111111110111100111011011110111111110001111111111111011111
011111111111011101a1111111110111111101111111100a011101111110a111001111101110011010111100111111101110101100011101110011111101111111111100111011111100100110111100
001111111111101100a1111011101111111111111111101a111111111111a101111111110111111011111001111111111111111111111111110111111111110010111111001101101110111101100100
111101011111111111a1111111111001111111111011111a011111111001a110111010111011111101111010111101101100111111111111000101111111110011111111101111111111111110111011
101111110001111110a1111011110101111110111111101a100011111111a111111011011111010111001111111110111111011001110111101110101001010101110111111111001111101011110111
011111011111111111a1011111101011011101110011111a111111101111a111110111111111101001110101110011011111101101111011111111111010111101110101101111110110111111001111
111110111111111110a1101111111011111101101011011a111111011100a111111111111011111111111101111011011111101111111110011011111111111111101001111111111110101111001011
111101111111111011a1011101111111001110010111111a111111101011a111111011101110011111001101111111111110001111111111111011101010111110111101101111100111101011111111
111011010011100110a0111011110001111111111011111a111110011111a111011011101110101111010111110111111101101101101101111111111111111111111111111011101111111111111110
010111011011011110a1011111111111111110111101111a110111111011a111110111011101011110110101111111111100111111011111111110111111111111111111100010110111011111010101
011111110111011110a1011110111111101111111011011a101011110111a111011111111101111111111111110110111111111110111111111100011111111111111110110111101111101101111111
011011011101001111a1111110110101111111010101101a101111110111a011110101111011110011111111111111111111100011111100100111011101011011101101111111001111110100111111
011011111101011101a1111110111111111101111111111a111111110111a100111111111101111111101111101011111111111011111011111110111101111111110110111101100101101101111111
101111111101111111a1111111111111011011011111101a111111011100a100011011011111110111101110110111100111011111111111100111111000011111100101111111110110011110111111
110111101111101111a1110111111010110111111111111a110111111110a111101110111111111101111111110011111111011111011111011111111101110101101110111111101101111111101001
111111101011001111a1011011111111101111111010111a110110011101a111011110011111101100010011111101111110111111101111111101111111111111111111010111111001111101111111
011111010101111111a1101001011101111011111111111a100111011111a110111111111010011111111010111111111111110011101111011111111111111101111111011111111111110110111111
101111110111111111a1111111111011111011111110111a111111111111a111111111111111111101111101111011111001111111111110111111011011010111111000111010101001110111011111
110100111101111111a1110010101010110111111111111a011111110111a111111111111111110111111111111111011110111001121101210110120121201221101010101111111111111111101101
111001011111111111a1001111111111111111111111111a011111010111a111000111101111110111111101000111011111112021101120110212021121220222220111111111101100101100110111
111101111001111101a1001111111111001010101111111a111111101111a110111111111010111111111111111101111100111220102001111202121220021211211111111110011011111011111001
111101111011111111a1001011111111111111111111100a011011011111a111111110011111111111111111000110011111112122221211122010200201222002201011111111111111111011101010
010111011110111101a1111111100011010101111111111a011101111110a001111111110111111111010011111000010111111210211212011101222010201210222111111010110111100010111111
111111111111110111a1111111101111111001111111111a111011111101a111100110111011111111101111101101111111112120121102211111102121200202112110222102211122112101020121
001110111101111011a1111100111111101110111111101a111110110011a111010111010111110111111111101101011111110010122211220012122111201010210112110120211122222221200210
111111111111111111a1111111011101111111111111111a011011111011a111011111111110110111011011111100101111111101211121212210112102112121122111212020121112200121201021
111111111011111111a1111111111110011111111001001a111011111111a101111100011111111111111110001111100111112021121211201100111102120111212111211101211021112121122212
111111111111111111a1111010111111111111011110011a111111111110a111101110101101111011001111101011111001102201211020012021202101020222201111220220002220111022112222
111111011111111011a1011111111111111011111111111a111111011010a110001111110011111110111111111011111111002022210021100012122212202121020112212102121220020221222220
111111011011101111a11011111aaaaaaaaaaaaaaaaaaaaa111111110111aaaaaaaaaaaaaaaaaaaaaaaaaaaaaaaaaaaaaaaaaababbbbababbbababaaaabbabbaabbaaaabbbabaabbbbababbabbbabaab
111011111111111011a01011110a101111001011001100101011100111100110111110011011101111111101011111110111111012211221210212201021020212221112012100212111112121211122
101111100101100111a10111001a111111011111111100100111011111011101111111101111111111111011101111111111110222221211121012222001212221202122112212000022022121012121
010111111111001111a11111001a111111111111111111111111111111110111111001111111111111111111111011111111112222112211120211110121022120020122122222222220222012222212
111111110111101101a11111101a011111011001111110110111110110110100111011011110101111101111011111111111111122010211212100100022110221221021201000010121220220221122
111111011110111111a11111011a011111111101111111010011011111111001010110011111111111111111111110011001102002110101111122021012221201111122002222222222222112221112
111110101111011111a10111111a111110111111011111111111111110111101001110011111011111111011111111111111112222012111222122211022222202212012222202222222022020101120
111101111111010110a11111101a111111101001111111110111011111001011110111111101110101011101111111111111111211022122221120221111220110122121022222222222222222122221
111101111110111101a11111110a101011100111111110010111111111101111111111110111011100111111011111101111112101111222121111001122220122221202110212100122212222220112
011111111101111111a01111111a110011101001111111111111111111111111111101101111011101111111111111111111012220121221221221221021211202222221121021221222222222202022
001111101111001110a11111101a011111111010110111110111101111011011111111111111111111111111111111110011111222120020222122121121102001222202221102222202022212102111
111111111101111101a11011111a111011011110111111000111111111111111111111111110101011110111111011110101112222010102101221212101022012222021002022222202220222112122
111011101111111111a11111110a111011111111111111110011011110011000011111011111111111111111101111101011102222202112121222012110102222222202222202200120212222210212
011110111101010101a01101110a111110111111111111101111110111011111111011111111111111111101101110110111101220212021122000220220222020221122222221021201221121012110
011110111101101011a11101111a101111111001111111101111111001111101111111111011110010011111111111111101101221112212221210021112120212210012222221221112122222222101
111111111111111110a11111111a011110010011001111011101110111011001100111111111111110110100111110011111111222102120122202202212022222222222222022222222212121212122
111111110010110111a01111111a111111111100011110101101111011101111111101211111202110022221202121000211110001122221111012222122222222202222220212022022201022222022
111111101111111111a11011111a111111111011111101111110101011101011111221110121111011102122022212211111101221212102221022022020222002222122222220201022202222021112
110111001110111111a11111110a111101111111111011111101111110101111101102211220221111212220201101111211111222122102011102222222102201222200222200202022221022220120
111110111101111111a11111111a111110111011101110111110111110111100111011012221210112121210112112121111011022202222112122012222002212222202020222222220222222222222
111111111111111011a11101111a011111111111111101111110101111101110111110120021111111221222101110021011111110100111111121012201222200220222202202120122222222022021
001111111111110111a11111011a101111111111111101111111111111110111111111221210212212122122222221121211111110011111111101220112222222212020222220022220222220221002
111111001110110111a11111110a111111111111010111111111101100111011110002211011221122122210222002111111111111110111011121221020012122222220222222222222012022022220
110111111111101110a11111111a101110101110011111011110110111110110100022200212120111000011011221212011111111111111111122101221121122222221021220221222022122020022
111110111011011111a10110101a011101111111101111111111001111011111111211120122022222112221012120112210011111111101111122122222112222212222220222202222222201222220
110111111011101110a01111111a111111110101111111111110111100011111001100212212102011120112211210012111110111111111101121221101022022020221210212210222220222021110
011111110111101110a10111011a111110111011110111101111111011111011111210122012012211110001221201110211111010001110101120121212212022122202222022221221221222222212
111110110111011111a11111110a011111110110111101101111101111110001111220112222112110210111101212102001111111011011010102201201012211222222222222222221120212212112
111110011111111111a10001000a001011101100001111111011111101111111111022202010202202221110012011221211011010011011111122111102122202212022222012122222202222221112
111111101110111111a11111001a111110011010011111110000111011111110110220122010201220222121112221211211011111111111111100210112211222222001220222222221221220222022
011111111111111111a11011011a101111111101110111111111111111101111111220122111221222222211102111212211011110011111111101202011202112212222222222022222220212220210
101111110101111111a11111110a111100111111011000110110111100111110110210112120212121220211001010110011110111111110111122111112110000022222222221210222021222222121
111100011111111110a11111111a010011111111111111100111001111111111111112112122022101110022011221211011111110110011111122211222222202110211022122222221010222222201
001010110111110011a11111111a111101110110111101111111111111110111111122221211122022122110211211210211010111111010111112022112220120112120212211220021211222120222
110111111110001111a10111111a011111111111111111000111111101111111111221221122021021200020220011121110111111111011111111022211102222022202220222122222200011112121
111111010011101101a11111111a001111111111111111011111011110001111110101121122201021012212211122212010111110111111111112212010121012022122102222222002112222222212
011111101101101110a11101101a111001111110111111111011111111111111111212200110211112022112112112110011101111011111111001120112212221112222222022221200100122021221
111111111111111001a11111111a111111011111111101111101111010111110100112112111221120221022202011100201111111111111111120212221121111212220220211210211202211211121
101111110100101101a11111111a011111101110111111011111111111011111111221022101222122221100201110020211101101110111111122121111210120122011221202212221221202101111
101111111111111011a10100111a11101111100111100111111110011111111011121201112210220012211221011110011111111100011aaaaabbbbaabbbbbbbabaabaabbbaaabbbbbabaaa00121222
111100100111111110a10110111a11111110101111111011111111010111111011101220112222120222110101211012001111111110110a111101122122122222111221221202202121110b12122211
011011111111101101a10100101a10111111111111101110111110111101111110102011001002101200222012201212211110111110111a101112202211222111022021212222202011102a00122020
110111101111100101a11101011a11001111001111101111111101101101111011110122121210212110212220121111220101001111111a011102111120202111112220200021222222121b20111211
110101101011111110a11101101a01111101111101101001111111010111010111100011122122112211122201000110101111111101011a011122221110222220000222122222222211101b11110020
111011001111011111a11101011a11101111111111111111111111111111101111022212122211022102222120202222121111111101100a011001221020111120122201222210121222220a12222011
011110011111111111a10111111a11101111111111011111111111111101011011010010221211222121122112220211221110102210110a220022200210212122222122220022211220222a10012201
111110111111111111a11101011a11111111110110111101111110111111110110111121101112110022111112121212021121021000221b112220111220101212011212221211201222120b21111111
100111011111111111a01111111a01101101100111111110001111011111111011101111111101111111111111011111110121111022120a112122101201211210101111111111111101110a11111011
110110111001101111a11111111a11011110111111101101111111111111000110110101111111110111111111110111010110212221202a120222022112212211011011111111111111110a11111111
111111011100011001a10111101a01111111110111000010111111001011111111001011001111011100011110110010111100210122020b012212021222111120111111011110111111111a11011111
111101011101100101a11011111a11101111100111111000101110111111111111111001111011110110111110110101101112200220121b122121010112221012211111101011111101111a10111111
111111010101111111a11100110a11011101011111111111111111111001011101011111111111110111110101100111101102122010220b002222120202120222111111111111011110111a11011111
111111111111101111a01111010a11010111111111111111111110011101001111111011111111110111011101111101111122100121101b121012012221111222211111111111111010101a10011111
111111010111111111a11110111a11111111111111011101010111111010111111111111111111101111110111111101011101212002010b111120212002102212111111010111111110110a11110101
010111111111111101a11111101a10111011101111111111111111011111101000111111111011111011011001111111001120122212021b110122221101121222211110101111011011111a11011111
111111111111011101a11111111a11110101010111011100011111111110101111110111111111111101100101011111111110111111021b220212111102211210111111111111110110101a11111111
110110011111111101a10111111a11111111011111110110111011111111111111111111011001111111011111111101111011110212111b110101121001011220211101011110111111011a11111110
011010011111111010a01111011a11111111111001011011111111111000011011110111111111110111001101101101111102201011202a100122222210022212111110111110101011011a01101111
101100101111011111a11101111a10011110110101111110111111111111111111111111101111111111111111111011111121211012220b102112021111212001111111110111101111111a01100111
110011110101101111a11010110a11111111110111111111010011111111101111111111001111110111010111111111111112222121122b211022121112122021210111001111011111111a01111101
101111101011111111a01111101a11011011111110110111110111110111111111111110101111111111111011111111010110110211122a222222021112212120101111111110111111101a11111111
111111101111111111a11011111a22011221220112222221122211120211111111111001100100111111111111101111111100201121211a022211100221211222211011001111111101101a00111111
111111111011110111a01010101b11111111222110102022111022021111111111111111111111110111111101011110111102220001211b222121221102122212001111111111101111111a10111111
001101101111011011a01110111b12222101221201111222220011221011101101111101011101011111111101101101111111001210121b122112212211221011101010101111111111111a11111111
101011111111111100a11110111a21202111202122121011120220211011100111110011011011011110111010111111111111211122210b211112221012012022001111101111111101011a10111100
111101111111101111a11010111a11222011112211222202010122110210111111111110111110111110111111011111111120022121110a211101211122001111211110011111111011011a11110111
000010111111111111a01011111a12211101111122120221120102221111110111110111111110111111111011101111111122012102201a011120111112221200101110111111111111111a11111111
111111111111110101a11011110a00121201202211102220221112112201111110111100110111011111111111111111111100122121222a222021011101221102211011110011011101111a10111111
011010011111011101a11111110b11221212222010111101111121212011010111111111111111111100100111011111111112222121020b121222202012212201211111011100101101111a11111111
111001111101101100a01111110b00122022102212021211202120212101011111111001011111110110111101111111111101121012222a200112120221111221211111111101110011101a11100111
011101011110100101a11111100a11121211022222022102020010110211111111101111101101111111111111111111100022220112202a120120222211101012100101111101111110111a11011011
111111011111010111a11111110b12110212222222112011220121210111011110110101110101110111111111011111111022211211202a010211120112101011211111101111111011011a01110101
111101101101111111a10111011a21102102202212210211122222110111111111111101111111110111011011111111011021121202011b020110202202122212011111111111110100111a10111110
111110111010101111a11010111b12212012211121111222022212211201111011111110111110111111111110111111111112111200010b122110221020222020201111111111111101111a11011111
101111111111101111a11011101a12200110001210221212212121212011011100011010101111111111111111111011110100210010202a120211122011101100211011110111011110001a10111111
111011100111101111a10101111a10220112211101101022221101122111110111111111111111011101111110110111111110221222211b112221121121201211111101111111101101111a11111010
111101111100100110a11111111b12222102111101001022122111010011111001111111110100111111110111011111111010111111101a101111111110111111001111101101111111111a01011101
011111111111010111a11111111a10221200201210012012112212011111101111110111011011011011111101101011100101101111011a011111111111101011101110101110110110111a11111111
010101111111011101a11111101a21111112111210112201211120221011111011111110111111111110111110111111111011111011011a110110101011101110111110111111111101111a11010110
110111011111101001a11011111b10201211111110222002112022011211101001011111101011011111011101101101011100111010111aaaaaaaaaaaaaaaaaaaaa1110011010110111100a11111111