150 67
1 67
108 1
53 96
149 59
159 5
59 25
76 24
0 63
85 56
1111101100111111100100011001111111100111011101111111111111a11111011110111101111111111a00111112222112222102212100222220121211010111111111111110101b2120220120220b
1110011111110111010110110111011111011111111111101111101111a11101111101110110110111011a11111112010112112110121212222002201221011101111000111011112b2100022202101a
1111111101111101100111011111110111111111101111111011011111a11110111111101110111111010a10101112120101221212110111110211221120111111101111111111102a0112212212221a
1111111111011111111111111001101101000101111101111101111111a11111110110111101111111110a10111112111200212111022020111201021012011111011011111111111a1201021211220b
1111111110111111110111001011011111110111111011110011110111a11111111111111111111111101a01101112220201222102111202121220222021111111111110111111111b0012221102111a
0111011111010111111111111101111111110111111011111011111011a11111110111101111111111111a10101110111100120112120211201111220222111001111011110111111b2211222222211b
1101110011100111011111111111011111111111111111110111111111a10111000111101110111101111a11010111112111112012210221121121121210111101111011111111112b1211111221221a
0110011110011011110111011011101111111001111111101111111111a11011111011111010111111101a11011110222212201101111222111002121002011110011101111111110a0212202121221a
0010111100111111110111111111111111001110111111111110111010a11110100110110111111101111a11110111221220101221021122111211211111111111111111111111111a1212222022201a
1111011011111010111011110011100100111011111111111111111111a11202111202022122001022022b21212112212011212210100122220111011102111101101110111110110a1101111110122b
1111111111111111111100110110011111111111101121121121211012b00120222120200212121222210a20012102220122011202212120011101121001111011111111110010112b2112122220112b
1111111010111111111111111111110010011110101111220022110011b00200222201222212211212011a22222202201111111022211110012122210211111111101111101111011a0112112102111b
0111111100111111011111101111111111111111111112201001202122a20112220022220221211121122b22022211121121101202111210221120022021111111101101011111012a0122122202201b
1111110111111001111110110011111111111111111101211221212011a21220220222022222220222102b10000111111210211110202122112220211101001111010110111111110a0110222211020b
1111101111100110111111111111100111111110111010011122221121a22202212222211221211101111b22101110221122202111121100121101121222011111010011011111011b1012211201200b
1101111111111111111111111110010110111111111111120112001011a22012021102220220200000122b12120101221222112011221110220201100122111011111010101111111a1212111222210b
0011101111101111111111111100110110110111011111222122111212a11110210222211101221102112b00121211102111211010010101021012121212111101111011011111011b1120222210202b
1111011110111111111101011110101110101011111112212002121211b10222220212220021222102212b10120211111111111101111111010101110111111111110110111011112b0011221021101a
1111100111000111111111111101101111011110111112111201110111a20220122202020021101111210a12222111111101111101011111111101111111101001111110011111011b2222101000012b
1100100011101011111000111111111011111111011111001200222221a21222222222122222012222102b10211111100100111101111111111111111111111111101101111011102b0011200110202a
1111111011111011110111110111111111111011111022210211100211a12222022022221221100211202abbababaaaaaaaaaaaaaaaaaaaaaaaaaaaaaaaaaaaaaaaaaaaaaaaaaaaaba2012210122100a
0111111111111011111111111110111111111101110111121122212222b2201222222122202220202122102210210010101011111111111110110111110111110111011101011111111111111111111a
1111111111011011111111011111111111111111101122222111111111a1122022112212021111201012220112111111111101111111111111101111111100111110111111100111111011111101111a
1000111111111111111111011101111011100110110000222011122122b1222002122212221110212220112121121111111111110111011010111111111111101101111111111111111111111111101a
1110011111101011110010000110111111011111001121211011122222b2102220201222111121202022112120111110101111111101111101101011010111111011110100101111111001011111011a
1111111111010010110111111110111111111111111101211221121121b0222222022020110221212122012111021111111111011111111110110111110111111111101110111100110111011110111a
1001110110111111111110011011111111111001111122221212012112b1122122202220221111121112111112111111110111111111101110110101111100111001111111111101101111111110111a
1111111111111011101111011110111111111101011121020221112011b2122112212220221012211220112012010111111101111111101111011110110011011101011111100101111110111111110a
1111011100101110100111111110111100011101001112022212212222b1002222122222212111112021221212221011111111111001111111111111010111111110001111111011101111110111110a
1110111111110111111011111111111111101110011102222211122221b2222202012112220012211120221222221001001111111111110111111111111111111111111111110111011111101101111a
1111111101111111010111111001111011101111101122210211201211b2021200222220221112211102121122110111111110111100101101111011111011110111101111110111110111111011011a
1111110111011001010111101111110111011111111110012001012021a2120211221220022202101221102220121111111111111100111011111101101110101000001010111101111111011111111a
1111011111111111110011011111111111101111110121012221212222b2112222212222002110121122202112121111011101110111110010111111111110111101110001110111110110111011111a
1010111111111011111111011011111111111110111121111212121212b2200220122021222221121201111211001111100111111110111100111111001110111111111100111010110111011100111a
0111110111111011111111001101101111111111101122112111211222b1221122221122021222112110110101110111111101111111011101111111111101111111011001111111011111110101011a
1101110111111111111011101111111101111111101022100120120211b0202220122201120212111022011112121011111111111111111110111111100100111111011111111111111111111101111a
0011111111111100110101111110111111110100101121011212112122b1222200020022222222221120110110101111110101111111111110111111110011111111111101111110111111001111111a
1111111111111110100011011111111111110011111102021202221122a1200120200220222100210110201021021110111111111111101111111111111110010111111110010111111111111001110a
1111001101011111111000101101111111111101111121021112222122b2201112122212022102222111102221111111001011111011011110100111111111111111100011111011111111100111100a
1101111011101011111111111111111111011101011112222002122111b2002220102222222022222211120011011101101011111010111111111001111111101111111111100010011111000111011a
1011111111111111111111011101110011011111110121212110201110a1022111221110100101011011111111111001111001110101111111011111101011111111100101111111111111110111101a
1111111010100001111101011000011011110110111101011110101110a1001101111121211111210122111022200210200211111111111101000100111101111000111111110011111111110011110a
1010100111110010111011111111111111101111111011110011111110a1101010111111021211201102110111102011200021001111101100101011111111011110111111101111011111111101001a
1111011111111111111111111101011111110111111111110101011111a1111111110111001112122122111120122112121001111111111010101011011111111110101111111111111011111101110a
1111111111101011101110110110110111111111111111101011101001a0101101111121222221112120200221120222101211011100110100110111011111111101112221101211221012222222211a
1111111111100101111111111011111101011110111111011111100111a0111111111121200111122121210201221202112121010010111011010011101101011110111110212222111110222222222b
1011111111110111111001111101110111111101111111111111101111a1110110111120221121221022202112011012202211111111100111111111111011111111110222121112202202122021202b
1111101111111111100110111111101101111111111111111101111101a1101111011121020011202210212201122221122211111111111111111111100011110101101222221212220012221000111a
2121122111110212110111111111111111111111111111111100111101a1111011110112211111110202001211100012111221101011111111110111111111111010110002112212212210211111102a
1102012222021211110111011111011110110111011111111111101111a0111110110122222122020010112122122112201111011011101011101001111111111111012212222221221112122001121b
1102122121002111111101101111111001110111111111111111111101a1101111111121110221121120212220211001121011110111011110111111110111101110112121112011120112012112221b
2202111021122201111111001011110111011011011010101111110111a1011111110020222211122211120100220210112101100111111011111111111111101111112120212002101011221212100b
1222101111022122111110111111111101110111000011111111111111a1111111100110111111001101002022221120002120011111011111001110011001110110110201211021211012022021022a
2221101112022010000110111011111011110111111111111110011111a1011111011122112112122101212211012001202221101110011111111101010111011100010221220110221211111211212b
aabbabaabbbabaaaaaaaa1111101011110111111111111111111111111a0110110110100122220202201100111020111022221111111101111011110111011111111112222211111201110201121121a
10111021222110221011a0111011111100111111011011111111101111a1100110110102122022121220122122211021220220011111101111110011101101111111112110221020022122111121112b
20121220110100201111a1111111101011111010011111111111111111a1011111111122101110111221022212121210021211111110111010111101111101111111111112112012112122002212110b
11112112120212111111a0111111111110101111110011100110101111a1101001111111212221211222121210221212021211111111111111111111110111101111112222211101100200211112111a
20112122112112221010a1111111111011111011111111111111111111a1111011111112111102120122221021212222122200111110110001011101101111111101112222211112111121211210211b
12212212212111111011a1001111111111111111111111101110011111a1111010101122022211112111112122212221212021010110111111111101111100111111102211122111222011111222111b
21211010011212201111a1101111111111111111111111101101111111a1111111111101112121102122120201012222212121011111111001111111111110011001112022222112202201221111011a
10002121222112211011a0111111101111111110110111111111110111a1111101011100112212211112102112201021011111111111101111011011111101011111110221211211011110221110112b
12021112111221201111a1101011011110111111111101110111111100a1111111011111010002222112211120210222020121111111111111111110111111111111111012222121221022202120212b
21111221012222211111a1011111111111111111111101111111111110a1001101111021121221202111122002211111221211111111111111111111111111101111112110221212221212111220101a
21000212010100121111a1111100010111111111101101100111111111a0110111101111101222021202100001000220121121111111111111101101111011111111111020210011210122220021101a
21001212022222221111a1111111111111110110111011111111111111a1110111011102110010110011112221101211220211111111111111111011111111110101011112212221202212210022022a
22101222001211220111a1111011011111011110111010101110111111a1111011110102211211022002010011112012121221111101111001111101111011111111002011121111112000022201022a
22101010121222120111a1011011111111111111111111011100111111a1000110111112122110111010222121102202222111111000101110111010111010110111001112121102011222202112101a
12122211212201101111a1111111111111111111111111101111110111a1111111111100021201211122022210220000222111101011011111111111111101101010111122211200011002022112112b
12222022220022121111a1111001111111010111111111010110111111a1111101101112011011220022222010112021100221111111111100111111111011110111111211221011220221111110201a
21120022121121221111a1111111111111111111010011101111110110a1111011111101122212101202110220111211121111111111111110100111111100111110111202022221021220222210222b
10211221202201111101a1110010111110111111101111101101100011a0111111111120212211100202010112210122200101111111101111111111111110111111111222110021201122022220211b
22200112221011120011a1110111111110111101101101110110111110a1101111101111111111101110111110111011101111110111111111011111111011110111111021120120111110111010221a
20122121221222110100a1111111111111110111110111001111101010a0010101111110011111001111111111011110111111111111111011111111100111111110110021012211122212011111211b
11001112122122120111a1011011110111011110110010101111010111a1111010011111111101101111111111110110111111001111111111000111110011111110111122220020012212222212122b
12201212021201121010a0111101101111111111111101101111111111a1111111111111111100111110010111100011010111111110111101111011110111111110010110101011111101110111111a
01210121121111200101a1111110011011110011111011111111111111a1110111101111111101001011110111111100011111111111101111100111111111111111111011111111111011101111111a
01120112211102011111a1011111111111101010111010011111110001a1010111111111111111111111101111111111111111101111111111010111000111101110001101111111111111010111110a
21002101011000200111a1110111111011110101111100101111011001a1011111111110101111011011111011110111111110111111111011111111101111110101111011111110111111111110101a
01101110011111011111a1011110010101111100111011111101110110a1101001111111110101110111010111111111111111111111011001110111111000101101100111001111111111111111011a
11111010111101111111a1101011111111111110111110011010111111a1011111111111110011111011011101111100111110111111100101001111101011101010111111111010111011111110111a
11110111011111011111a1110111101111111112210122210222212222a1210222002111010111101111111110111111011111011101111101100111110110010101110110010111011011101101111a
11111110011111011111a0111111110111111121122121211012101201a1111210121111111001111011001101011101111101111110111011111110111010111010111110101111111111101110111a
11111011011111101111a1111111101111110010102111111222201120a1012100012110111100101010011111111111100111110010111111110011111111111010111101111111011111111111111a
11111111111111111110a1011111010111101111021220012210221202a2220020010111101101111111111111100111111111101111110100011111111001101111111111111111011011111110111a
11111111111111110011a1111111111111111121220202221222110012b2001021021111110110011110111111111101111111011101111111110111111111111111111111111111111111111101111a
11111111111101011111a1111100110111111120012211222211222221b1212012122100011101110111111100011111111101111101010011111111001010111101011111111111101011110101111a
11111101011011111101a1101110110111101101222121201200111022b1101211200011111111011111111111111110001110101111111111110001111111111110010111010111111011100111101a
11001111110111110101a1111110111110111112112210122222022221a2212122121111111111111111101111100110111111110111101111111111011111111111111101001111111111011111111a
10111101111111010111a1111101111111011112121122012122102212b0000211022111111111111111111111101111111110111110101011111111111110110111101101111111101011111111111a
00011011110111110001a0100101101111101112120101202120121211b1100212210001101101010111111111111011111101111110110110011111110110001111111111011110011011111110001a
11111111111111011100a1111101101111000111012111222112101220a2122222111111111110111010101111101011111101111001111101110011111101111011101111111001111110111111111a
10011111110011111111a1101111111100111111102122112121201001b0211110012111111010111011111100010011001111111100011001110101110101111111111110111110101111101111111a
11011101111101011111a1111111111111110100210212111212221222b2220112222011101110111110111111011111101101011011011110111111111111011111011110110001111101110101011a
11101111111111111110aaaaaaaaaaaaaaaaaabbb21211222112012001a2200121110111110111111011111111111111011111110111010111101011111010100110111111111111111111111010111a
0111011101111011101111011111100101110020a22012121010222222a1222121211110111101111010111011111110111110101000110010111101111011101111101010100111111011111111111a
1111111111011110010111111110101010111121b11210122221010011b0221111222111010010101111111101001111101011111011111111100111111111001111111101011001110111111101111a
1111010010011011101011011111111101111121a21000122021210222a2212201210011101010111111110011111110111111110101111111011111110111110000111111011111111111111101111a
0101101111101111110111111111111101110122b10021222201110201b1211210122111000111111111111010111110111111111011011111111111100011011111111101011111111101011010111a
1111111101101111111101111101111111111021a01210222121222022a1112220211011110111111001111111001101111111111101011111111011111111110110111011111011010111111111111a
1111111010100111111111101111111011111102b20220221221111222a0112202012111011110111011111111111111101110101111110111111111110111111111101011111110101101011010011a
1111111111111000111111111111111111110102a21111122221111221b2011222222111101111111111100111010111101110111010111111101111101110111101111101101111010111111111111a
1110110101111110111101111111111011111012b12112212011212012a2210011211111111011101110011011111111110111011101111111011101011011111111111111101111111001111100101a
1101110101101111101111110111111110100112b12200220212010022a1222110222111111111111100111011111111110111111111111001111110111001101111101111011111010100111111011a
1110100111111101001111101110011011111122b20102120022222201b1002200022110111001111011110111111111111001101001101110000110111111110101101111110011111111100110010a
1111111110111111011111111111101111111101a10112020112122212b1211211220101111101011111101111111111011111111011111111111111111111011111111111111111110111101111111a
0111110110010011111011100111001101111021b10112220111102111a2110122211111111110111011111011110110111101111111110111110110111111111011111001011110111101111111111a
1101110111111111111111111111111111101121b11122122122201102b1122111211110101001100101111111111111110111111111111111111111101011110101111110011110101101111111111a
1001110111110110010110111111111111111112a20120220222100012a2210122212111101111101101011111101111011101111111111111100011111011111110111101110011111111001111111a
1111111111111010111111011111011111111110b22101201211021112b1101211112111111011011111111111111110111010101110111111001111011111111111111111111111111011111011011a
1111110111101111101110101111111011001112a20100212120211201a2110202102011001110111111111111111111111111110011110111011111111111011011011111111011110111111011011a
1101111010111111111101100001001111111101b21012111200222221a0222211121110110111101011011110111111111011111111111111011111111111111011111011111111111111111111100a
1011101011111111111101111011111111111111a11111111110111111a1111101111101110111111111111010111110001110011110111111111011111111111100111011111111011011111111110a
1001111101111001111111111111101111101111a11101111101011101a1111010111111111111111111110111111111111010011111111011111011111111011111001111101101111101111101101a
1111101111111101110001010111111111111111a10111011110011111a1111011110111111111111011111111111011101101111111111101110111101111011110001011011111100111111011111a
1111010111111111100110110111111111101111a11111111110111011a1111111111111111111111111011110111111101111001010111110111111111111111110111011111111110110111011111a
1111111111111111111111111111011111011110a10011011111111111a1011111111111111110011111110101110111110111111111011111111011101101111110011111111010111111111011100a
1111110110111011111110111111101111111111a11111111111100001a0111011111111111101011100011111010110111101111111110111111111101111110111111111111111111111110000100a
1111110001111110111111111111111110111111a11101101111111111a1111111111101111111011010101010111111111011111011111100101100011110111101011101101101111111101110111a
1111010101100111111101101111111111101111a10111101111100110a1111111111110001111011111011001111101010101111111111111101111011110111101111111111111100110111101111a