124 101
0 45
3 98
101 75
47 63
57 44
39 62
45 41
41 76
62 38
1111111111111101111001001111011110111111100a11100110010111111011101110100100111111a111110011101111111111a0101111101111011111111111111111111111101111001111111111
0111111111111111011111111100110111111011101a11111010111001111101111111111110011010a111111111111110111111a1011111101111111000011100101111111111101010111110111111
1011111111111111111101111001111111010111110a11111111111001010111011101111111111111a111110111111111111111a1111111111010011011111111111100011111001111110110011111
1111110101011111101111011111110111111011011a11110111011111111110001000011011111110a010111111111011110001a1111110111111101111011111111101010001111111011011101110
1111111011011110011010011111111111111101111a01101100111111111111111011001111111011a111111100010010111010a1100111111110011111011111111100110111111110111111110011
1110111111111011111101111111110111111111111a10101111011110001111101111011100111111a011011011101111111111a1111011011111010101111111111110111111111111101111111111
1000111110011111111111111100111111011011111a01011111111101111111110111111111110100a111100110111111101111a0111111101011111011111111011111111111110011101111110111
1001111010111010111111111100111011101111011a10110011111011111111111101111101011111a101111111110111111111a1101111111111001011111011011111101111111111111111011111
1111111101110110110111111011110111111111111a11111110111111100110111111111110101001a111010110111011101101a1111111101101111110111101110100111011111110111101111111
1111111111101101111111011111111101101111011a10110011111111110111110111101111111101a101111101110101111011a0111111011101111011001111111110111001101111101001111011
1101111100111111011111101111111111011111011a11111001111110111111111101111111011011a110111011001101101100a1111111001111101001111010111011111110111010110101111010
1111100111111111111001011111011111111111111a11111111111101111011101111111011111111a110101111110111011111a1110111111010011111111111110001010010011101111110101010
1111101101111101101111011111011111110011111a11111111101111100101110111111111101111a110111111111111110111a1110111001111111110110101111111100111110111010111101111
1010111101101110111101011110101111111000101a11111001100110110110011111111111101111a111111111111111111110a1101111110011111111111111111111111111111111111111101111
1111101111111111101101111111111111111111011a11110101101111101111111111111101110001a011110110111101111111a0110111010011110101111111011101100111110111101111111101
1111111111111111111010110111011111111111101a11011111111101111001101111110111111111a111010111111011110101a0111011101111111111111100011111111110101111111111111101
0101111111101111111111111111111111111111111a11011101111111111101111011111101101101a111101011111011101111a0111011110111100111111111111111111111111111111101101111
1011111011111110011110111101110110111101111a10111111101110110110111111111011111111a001111110111011011101a1110111100111001111011110111101110011111110101110111001
0111111111110111111111111111111111111111101a11011101110001101111110111111111101111a101101111111111111011a0111011111110111111111110011101110001110101101110101101
1011111111111111111101111111111011111111111a11111101101111111110110100111111000111a110111101111111010111a1111111101111111011110111011101101110111101011111101111
1111111001010111111011110111111111110110111a11111111111011111111111110111101111100a101111111101101011011a1111110111101111001111111111110101111011111111100101110
1111110111111101011111110111111100110001110a11111000110111111111111111110111110111a111111111101010111110a0101001111001101111101101101010111111111001111011101111
1111011111101010111110010110111011111111110a11110110101110001111111110111101101100a111111111111011111111a1111101101111111111111101100101110111010111111110011101
0101111111111110111111111110111111101111111a11021222012122212112022121211111021101a011111111110111111101a0111111110111111111010111011110101111111011101101111111
1111111111111011111111111111011111110111100a11121220222011120220100212200212111111a101111111110111110101a1111101010111111110101011111111111101111011011111101111
1101101011101110111111110011111011110101101a11110202112120221021212122121011101010a111011110111111111011a1110111111011111111001111111101111111111011111110111010
1010111110111100111110110011111120112212120b21222112222202122212210022112010211111a011110111111111111110a0111011100111101101111111011111101110111111111101111001
1111111101110101011101111111101100211222011a11102122220210210211112222121012101101a111111011100001011111a1111111111110110111111110101111101111111011111111100111
1111011111111111111111011101112121001221210b11000122222102221212221211201201121111a111011111111111111110a1101111111111111111111011111110101111111111111101111111
1111011011111111010010011111112022112020212b10222212222212222011012120222110021011a010111110111011101101a1111010001110111111111101111101111111101111101100110111
1101111100010011011011111111112122212112012b21120221222212122220222211202001221111a111111011001111101111a1101111111111011110101110001110111111110101111100111110
1101110011101101101001111110012011221212012b02202222122220202212102221212212121111a101110111110011111111a0011011100111111101111011101100011101110111111110010100
1111111111101111011111110111110022022111210b22201222222022222022210222222121011101a101001111010111111111a1110111011011011011011111010111110110111011011111100111
1010011111110101111110011011011122011221121a21221220222221221221121101221221021011a111101111111011101101a1111111111111100111010111111111111000111111111101111101
1111111111011110111011110111100211121211210b22220212002222022222220211222120011111a011111110111111111101a1001111111111111111111110110111111111111110111111101111
0110111101111111111111111001101021122111022b11202202222222222102221021220010221111a111110101111111111111a1111111111110110110111111111101110111110111001011111101
0011111011110111110111111111111211121210111b02202120222202202222122002022122121111a011110111111101111111a1011111111001111111111111111101111110110001101111101111
1111111011011111111100111110101111122121002b22221102222222222102221222121121221110a111000111101011111111a1110111111111011111111111111011111111101111101110111111
1011011110110110111111101111111110212121102b21021221220222220220220210021111120111a011110111111101010111a1110101111011111101011111011101011111111111111011111101
0101111111111110101111101111102002212020112b20012020212210201201222222222111211110a111111110111111100111a0111111101110110100010101010111111111011011111011111111
1111111111111111111111111111010021121200222b22020222212221020222221222222020101101a101111011111101111101a1011111010010111001101111111111111110111111101111011111
1110011111100111111111101111111221121121212b02222210221220222000200011212222121111a110010111110111111111a1111111101101111111111111010111011111111100111111111011
1111111111100110111010111111102112102121112b22211222000122221222122122000220111001a010101011111111111111a1110111011101011101111110101111111111110111011110100001
1101011111101110110111110111111121221202200b22002220022212222002212220220212121111a111111111101111111101a1111111111111110111011010101111111011001011101111101111
1111101010111111100111111111101210101112222b22222202220002122222112222111222020011a111101111110110111110a1111111011111010111111110111111111011101110111111111000
1111111110011011111010101011112021101120211a22222222222222222222222222122222011110a011111110111011011111a0101111111111111100011111111011111101011111111101111101
1101011111111011100111011101111202101102211b20122221222021022011122222011121121111a111111111111111011111a1101111011111111100111101011101110011110110110111111111
1111111111111111111000011111121222202020120b22222022220220200221020222122020121111a101111111110101111000a1111111111111111111111111111101111111111110100011111111
0101011111111111101111112102122212222222222b22222222202222222212201222220112121111a111111010100111111111a1110011111111111111011110110101010111111111111011111110
1111111111111111011011111212102222002220022b20021222122022202222110022222021020111a111111110111111100111a0111111111101111101001011101111001101110111111111111111
1011110110111111101111001110120122220222222b22222222222200122212221200202202021111a111111110110111101111a1110111111110111111111111111011100110111101010111101110
1111101010100111101111111210122212220022200b12222222002002222200221012221111101001a111111010111111111111a1111111001110111111111111111111011111011111111110101111
1111101110111111111011001200120222221222022b22221022222222202110202222222221111111a111111111111111011111a1111101101111011101111111001111111111111111111111111111
1111111111000111111011011211202021202122222b22222202000222222201022220002011101111a111111111011111111011a1000111111111110111101001111111111111100111001111110111
1010111111111111111111110021122222001002222b22222202220102222202222110121111010111a100101111110111111101a1111111111111111111010110111111011110111010111111100111
0111010101110111111111012021222002222202202b20022012210022212011210021011111110101a111111010011111010101a0011011111111111011111110111111110111101011111111111111
1011111111111101111011112221210222020022200b22222202202221122222211212011111111111a111111011111011111011a1011100111111111110011100111111111111111101110101111101
1111001010101110011110001122101121210121222b02222022222222020100210011221100111011a011111111101111111100a1000111111011110111010111111111111111111111111111111111
1111111111111101011111111220212120202212022b22222022220212220221201011122001110111a110111111110011111111a1111110111011011110111101011111111111111111111111110110
0110011011111111110101110212010211220221202b22212222112220222221211022120011111111a111011111011111101010a1011010111111111110110101111111111111011111100110110111
aaaaaaaaaaaaaaaaaaaaaaaabbabbabababbabbbbaaa21222222002012121110111110111111001011a110221212011222221210b2212022221211111111011101111011011111001100000101111111
0011111111111111101111111221222200202022222122222222222221111021111110111011111111a001121222021122111112b2111110021211111111111111111111101111111011111111011001
1011010110101011111110110222212222202222222222222222022011202000110101111110111111a111122221211222120211b1110010222110111100111111011110111110111110110111111111
1101111011110111011111112222022221022222112222210100222121000121011011101111101111a110122102122120122222b2002211121220111100111111010111001111011111011111100111
1111101011001101101111100022122222220121221222022222222121202011111111110011101011a111121221200101121221b0120212222111110111111111101111111111101101111111001101
0111111111111011011111112222212120202220200220221022202210011201001011011011111111a100122022112212112202a0222002221211101111111110111110111111111010011111111111
1111111110011111111110111200202220222022222221201212212122222111001110111111101100a101102002111222221010a0212222221201111011111110001111111111111100111111111111
1101111010111101111111112121102122122022022222222122221022221121111001011111110011a111210112212221121121a1110211002211111111101111111111011111111101111110111111
0110010011111101110011011121221122222222222122221222221212022111111111111111111111a010211222021211121211a1201112012221110111011111111010111010101111111111111110
0111001110111111010111110220222122222201122222220202022022022211101111111111111001a110102222122021222222a1220112211000111111111101101111111111111111111011010111
1101100101111111111111102122222022222212212202220222222121012101111111111111101011a111220212212011111222a1122101211011111011111101010001111101101111111111111111
0010111111110110110111012122221101222022221222220220202011211111111111111111011111a101101010222012210112b2210121122201001111101110111111011111111111110111111111
1011101101111111111101110222212100222122020020222022202202222120011010111111111111a111112210112212021211a1002112101121111011110010011001101011010111010110111111
1011011111011110111110101222212212222022120222221222210222210111011011011011010111a111212211120101110011a2001221110211111111010110111111100111111111111111111110
1111111111111111111101112222220222222222122222222222122122211121111111010011110010a111120210110010022212a2120102022011111111011111100101111110001111111011111111
1111110101111111111111110100222202202202222222222022222201221101011101111111111111a111222201220211222212b1201212202211100111011011001001111111011111110111111111
1110001101111111111111110211202222210222202012220222200201211211111011111011111101a111122101101212002121b1020102121111010111111110011111111110111011011111011011
1100011111111111111111112122221212022001122022202202222022122111111101111010111011a111221021211102111111b2221220210010100110011110111111111111111111111111111111
0111111011111111100101111101111122221201121200221122102202021121111111011111111011a111211101221102201021a0101000122020111110101111110111111111001111101011111011
1011111111111111111111111112221210011121221020122210100021111111011111111111011111a111221011212112012021a1210221122221111111111111011111101111111101110111111111
1111001110111110111111010112210122020221221021121201111211101011011111111101100111a001112110101222212101baaabaabbabaaaaaaaaaaaaaaaaaaaaaaaaaaaaaaaaaaaaaaaaaaaaa
1111111101111110110111110112221012002220220220220201020111110111111110111001101011a11110000111111222201202201111120101111001111111111111101010101011111111111111
1110001110111111111111101111112110101212212122212212012211111111110111111111101111a11022122201111201111121012222121101111111011011111111011011011111111111111111
2211011221022021111111111112111020112210122110211201101211110111111011011111011011a10102221111201122110021210012220111111111111111010011101111111111111111001110
1021201200012211011111101112222222201022200220111121202021111101101111111011010011a11011211011121221212001121221221021111111111111111100011111101111011011110110
1021212101222112111111111122022122112120122020110121120011011111011110110001111101a11122211212101120020111102111112111010111110011111001111111110111111010100101
1110021111111101200111111110212221101022201111000112210110111111011110101110111111a11002021111212022122212200122221021111111111111101111111111011011101111111001
0111201222201112211111111000011212121112121011122102110221111011111111110011111111a11122211012012212220210121112211211010111011101011111101111111111111011111101
2001112112111211022111111121122100110220221111221221202011111111111110111100111101a11101111012222221222221222222112210011111111111110100111111011111111111011111
2122220210012121212111111101121212010100221222010222211111111111111110111111111110a11112222211212222122222020102222211111111111000111111101111110010111111111110
1111221211122121221010111112021102222220120122222122111121111111011011101111011111a11000012222211010121000220201122120111101110111011100111111001111010111111111
2101011022201110211111111111111201110122122111101122121111111111011011101111111111a11111111101011101111111110111111110110110111110011111100011101110101111011111
2102001121101111110111101111100111010011111111111011111101100101101111101111111011a11111111001111111101011111110111111111100111111111111111110010110111010101111
2201121012102210212111111011101101101111111111101111101111010111111111111111101101a01111111111010111110111111111111111011111111111101111011111100011111111011111
2121201212121221211011101110011110110011111111111111111110111111111111001111111111a11100111111101111110001101001101111111011111111011111111101111111010110101111
2211112201110111111111011110111111111011111111111111101110111110111110110110101101a11111110111110011111101111111110110110111111111110011001111100110010111110110
1121112100212121120100111101011111111111101100111111001110111110111111111111110111a11111010111001111110111010110001111111101111011101111110111101101011111101111
2121112211220101111111111101111111111111110111111101111111110111010111111111111110a11110111111101111110111011110011011101111111111111111111111101111101110111111
1021011112122212110101110111110011110101111111111111111110100111001101011110101111a10111101111010011111111111111001101011111111011101111111111111011110111101110
1012120102220101211111111111011111110101011111111011011001111100111100111111110111a011111111101110aaaaaaaaaaaaaaaaaaaaaaaaaaaaaaaaaaaaaaaaaaaaaaaaaaaaaaaaaaaaa1
2212112120102211011101111111111111111101011111101111111100111110111111101111111111a011111111111111a11100111111110111111101110111111011111011110111001111011011a1
2220020212121112112111111010101111110111110101111111110111111101110101111111111111a110111101011111a01011111111111101101111101100111111101111011111111011110011a1
2222111000220102120111011110011011111111110011111111011111011101111111111010111101a110111111110101a10111111011001110111111111001111011010011111011111101011110a1
2122021022211110022110111110011110111111111101111111110011111101110101110111111110a101111111001011a11001110111110111110110111110111101111111001111111010111111a1
1001220120121022112111111111111111111111111101101111111111111110110111111111111011a110111110111111a11111101110111100111110111011111110111111111111010111100111a1
0122112212122112122101111110111101111000111111011111111011011111111111111111100000a111111111110110a10101111111110111111111111111010011111111110110100111111011a1
1201112121212112202110110111111111101101111111011111111100110101111111110111110110a011101111100011a11111111111110111111101011001111111111111110011110111111111a0
0120012020021010121100111110111110101111111011110101011110111101111011111111101111a111101101111101a11101111011110111111111111111101011111111101011111011111111a1
1210120101001210201011011111111111110111111111111101111001001111011011001110111101a101011111111111a11101111110111010011111111010011111110111111010111001111111a1
1102101212101012112010011111011111111111011110111111011111110111111111110100111011a111110100111110a11111111111111111111111111111111111101111111101111010111111a1
1210222221220122122111010101011111111111110110111101011110011111111110001111111101a011111101011101a11111101001111111111111101111101101001001110111100011001101a1
1022111211211011211111111111101011101111101111111111111111111011101010111111110011a110110011111001a00111011111110111111110011111010101011111111101110111111110a1
1100211220122121000111011011000111101111111001111101101101101101101111011111011010a010111111011110a11101111111111101111101111111111110111111011111101101110111a1
2101010111221001011101111111011111110101111110111011111001111001111101111101111111a001111111110111a01101111111111111111111011111111011111101110111101011110111a1
0111110111111111111101111011110110111111110110110011111111111011111010110101011011a111111111011011a01111111111101110111111111111110111111001110111111111111111a1
1111111111111111111111111111111101111111111011111100000101101110111111101111011110a011001111110100a11111111111111111111101011101111111110000111101111101111101a1
1111111111111111111100111011011011111101110111111110111110111101111111101011111111a101011110111011a11110101111111111111001111101011111111010101001111111101111a1
1111101100111001011111111101000111111011110111111111111011111110110111101111110111a111011111111110a11110111110011010010011101101111111101101101111111110111111a1
1011111111011101111011111011100111001000111111111111111111110111101111111111001111a111001011110111a11010101011111111111111111001111111111111101111111011011110a1
1011110110100111110111111111011110011111110111111111111110111111111111111101111101a110001011110111a111111111110011101011011111111111111111aaaaaaaaaaaaaaaaaaaaa1