5 117
111 4
66 28
71 82
52 72
124 20
150 71
25 15
82 95
142 119
1111111011212021121000210122010110222112211111011111111111111110111011111101111111111111111110011111a111111101111111100a1111101100101111111111111101111010111110
1111111111011012012122100210201211122211101111101011111001111111111110101011111111111011111101101110a111111011101111101a1101110111111011111011001011111111111111
0100111101211222012222201211221001102010100011111011111011111101011001101111011011000111110111111001a111011101011111111a0111111111000011110111111111011111110111
1111111111121101222012212221112121112201011101011111111101010010011111110111110110111001111101110101a111111111110101011a1111101101111111110111111110111101111111
1101101011201102020111202220010111211111010101111110110001110001111111011111111101011011110111111111a101101011111111111a0111010101111110100111110011110111101011
1111111111112202111101222012222220110201011110111001111101110111111110111111111111111101111111011111a111111112210221110b1012102112122011122211111011111110101111
1111110111211121021001221122000122212212211110111011111110011111111111011111111111111111110011111011a101111112221210002b0012122110211211102011010111111111101101
1111011100202212221020111222212101201022201111101111111011111110101111111011101101111101111110111111a011011112012011021b2212211222212111212101111011111011111101
1111111101010222112221201111222221001222111111111101110111011101110010110101111111111111111111111111a011101111212222111b1121202111011212011211111111111111111110
0011111111112002212111212111222121221122211111011111111110111111001110111111111111111110111010110011a111111010211221221a0121201010112022202111111110111011011110
1111011111111111100122101102112110211011210101111001111110111111111111100011111111111111001011111111a111011111201111121b0102012022211221210211111111110101010111
1111011111202202110110020122021211011020211111111111101111111011111111011111111110111111011111111111a111111111122111121b1021011102220121120211111111111111111101
0001011111121110112101221111012112122021211110111111101110011111111011111111101110111011111111110111a101111110222011120a2122111120202012100001011111110011011111
1110111001001112121222121002212202112121011110011112120002222021201120111022110122110111101011111111a110111012101021100b0121201110210122202201111101111111001111
1011111111012200011112011102112022221122211111011112112111021211101021222100121121011010110111011111a100111101121110112b1202212121121211112000110111111111111011
1111111111112012100212201212122122011112111110110101211212201212112211111111121112111010001011111111a111111111212121222b2012122212122221111211110011111111110011
0111011010112221102111122122212120111200211011111111121111021210120202212112210101111111111011111111a101110111211222222b1111222200102111212110110101111100101101
1110001011020211022122211221201111222220210111110010212122102212212221221212221011110011111100101101a110110111112112201b2211121111111121220211111111111110111111
1101110111112220111011202200222211022001211111111112212212012120120112022122201221101110111000110111a010111111010222020b1100121221112120011201101111010011111011
1110111110012120221022122121021112120111100111101111110212012222111212111011100211111011111101110110a111111111202112200a1102000201111201201110101111111011101111
1111111111110211210211211221220102102101211111110112020122111111012112012222120211111110111111111110a011101100122120121b2212222112212011021011011011101111101001
1101111111122011211201212022210222221202211111111012221102202221102222211212211102111011011111010011a111100112111110012b2122221200122211012110111100111111111111
1100011111110112212211011122212212122121211110111101122221222211202212220221022211111110101111111110a101101111001221221a2121212020212001212111111101110111111111
1110111111220112222222010211101021211021001011111101112110111210121222022211120120111111111100111111a111111011102210022a1100221122111000001211111101001010111111
1111111101212021212112022212111112122210211011111102111221111120210112021102022201111111110111110011a011110112222121212b2011222121012120001011111011111111111010
0110111111221122221022222221222022112212211110110111220002211111102212012101122110111011111111111101a111101011022122102b2110111121021120121111101111110111011111
1111111111022101120120212012111020221212111101101111121121221122022120101222210222011001111111101011a111111102202012102b1211202212011220210211011110010111111011
1111111111212112221222222122011122101110211111111011010120201211022221201121021211101011111101111101a011110011101222102a2022001111212121021111110011110111111110
1101010111122202122010202122110120002212110101101111111211122221222002120001200100101111111111111111a111111111111122001b1121112112122212012110011101111101111101
0111011111201120121221002211201120211220011011110110101222102201011222121102221022111111101010110000a111101110101002222b1222122211102222222011110111010111111111
1111110111120112112022220221211221112011110011111010120210211102021012011122210110110011101111001111a111111110220222210b2020101102112102212111010111010111110011
1111111111010111001111101111111111111101110111111111202221122110022100122201120211011111101111110111a111101100102212102a2021222220111110121211111111110111110111
1110111111111111111110011111001111111110111111111111112111110111011211221112111122111101111111101111a110111102012022220b1201220100110111110111101111110111111111
1110101111100111111111111101111111101011101001011012011222221022221122211212122202011111011110111111a001111112122122200b2211210211111022101111010001011110111111
0111111111111110111111011111101111111110111010010112101122121212201101011212222020110111101111010111a111111102011201112b2022111001221211211211111011111101111101
1111110111111111101000110111010111111101101011111112122211222222001221110122010222011101111111111111a110111110021110202a1121201212210112211201111111011110001111
1011111011111111010111111011101111111111110111111112122221202112221211020111221120111111111111111111a101011100011111110a1111111000110011111111101101110111111011
0111010111001101100011111011111111111111100111111111102120122120012212211121120012011110111110110111a111000011100110111a1111110111001111111111111011111011111111
1111010111101111111111111011001100111010111111101011220101022011222211102221221111100111111011111111a111111111111111011a1111111101111100111110111011110111010101
1110110101110101110111111111111101111111111110111112200121202212110011122112101210101110110111101111a111101010111110101a1111111110101110111111111111111111100110
0111111011111010111110001111111001101111111111101102200212221121000212011210112212011111111101011011a111111110101011110a0101101111111111111011111011111011110111
1111011111101111111111100111011111111111011011111010202121122110111220222111211212011111100111111111a110011111110101011a0111011111111111111111111110111011111111
1111011001101110110101111111111101011001111111110102211120201001112221200222010211101111111101001011a110111111111111111a0111110110111111111100111111110111111110
1111111111010110111111111100011110110101111111001111012111212212022011122221012121111110111100111111a111001101101101011aaaaaaaaaaaaaaaaaaaaa01111111111101011111
1101111000101111101011110111111100010101111111110101111011111101111011111010100100111111111011111101a11011101001111110101110111101110101101a10011011111011111110
1101110011101011111111111111111101111111111101110101111111111101110111111111111111111100110110111110a11111111110101111111111101011011111011a10111111011111111011
1000001010101111111110111111111111011111111111110111101111111111110111110111111101111111111011111011a11111011001111111111111111111110111011a11111111111111111111
0111011111101111111111111011110101011111101111011101011111111111111010111101110111111111111101111011a11111110101111110111111111110101011111a10010011111111111111
1111111111111011111011111111111111010111111011000111101111111111111111111111111111101111111101111111a11111111110111111001110110001010111111a11001111011111111000
0111111101111111111011111111110111010111111111111101101101111111111111111111111111111111111111111110a11010100111111111001001110101111111111a11111111111110111110
1101111011100110111111101111111111110111101111011011101111111011111111110110110101110111111111110111a11011111011111101101011011110111010111a11111111110111011101
1011110111111000111100110011100111011111101011110100111111111111101110011010111110011110111011010111a11101111011011101011111100110111111111a11111110111110111110
1110001110110011110111111111111010111111111111111111111111101101111101100011101111011010111011111111a11101010101011111101010111111011101111a11111111111011111111
1000101111011111011111111111011111111101111111101110111111111011111011110111111111111111010111111111a01110111111111101111111111111011111111a10111101101111110111
1001110111010111110111111011011011111101111111111001001111111101110111111111010101111011111101011100a11110110111111101111110011111101111011a01110101111111111000
01111101011011001111011101011111111111111011111111011110111111111111110011111110aaaaaaaaaaaaaaaaaaaaa11111111111111111011111111011100111011a11110010101111111111
11111111111110001111011100111111111111100010101111111101011100011101101100011011a1101110111111100111111111011011111111111111011111101101202b02102110202112022101
11111011111111111110111110111001101100122102221212120201202111012121011110111111a1101111011110111010111111011010111011110111111001111011222a20210220121222021221
11101111101101111111111111101110111111111112211212211222011220102112110111111011a1111101111111111111111111111111011011111111111111101010002b11122122200020201111
01101111110110111010111011111110111111211212212211112112021211211212111110101101a1110111101111000111111111110101011101111110100111111110222b21221222121211221012
11111101111111111111111111111111111011222022120220122111111001020010111110111110a1101111111101101011101100101111111111111111011111101110222a21012102211222222111
11111111111111101001101111111111110111111211101112010120211100022211111100111101a1110110111110110111111111111110111011001111111111111111102b12212210210201122211
01110011011011110111111111111111111100112102211112121122202211220222110010111111a1111011111111011111110101111011111011111111111111111110210b11211122221221220210
01111000101101111111010000101110111001112002212000221200110001012122110111111110a1101111111111011101111101101101110111111101110101011110220aabaabbaaababbbbaaaaa
11111111111111111111001111110011101111120111211122211111221112211221111111111111a111111001111111101111111111011111111110111011111111111211120102111221100101122b
01011110100101101111111111111111111102122111111220220021212212221122111111111110a110111111010111001111111111011110011111011011010011111102212222212212101122121a
11111011111111110111110111111111101012111202101121021101112111211221011111011111a111111111101111111100111111111101110111111111111111111111121211200011111022021a
11010101101101111110111110111011111112121111221211222111002210210212222112111021a221212111100010111011101011000100001111110101111111111221222102222212202210002a
11110111110110111111111001111111111112212102210022212220202022212010101122222011b201121111101111111110111111111011111011101111100111111022210122221210222012212b
11111111111111111111111111111111111100011100122022211212122222012002010101212201a210222111111111100111110101110011111111111101111111111220101022112212122201022a
11110110110011101111111110011010111101011022120201121011200222021101120121221212b020022011110111110001001111011010101111101101110110111202221112200212121220202a
11111101111110011111011111111111111111111111111210011111021121122022122000122211b112211111111110111110111110110111101111111110111111101122221110110011210000121a
11111111111011111101110111011110110111022220122101002111222210210102110100010212b021111111011111110111100111111011111101001111111111111112222110110120211121102b
11110111101111111110100111111110110112221011200012222212222222121021120122220102b102101101101101111011111011111111111111110111011101111111221121122001221221111a
01111111111111101111111111110101011112002201002112220100122001112020011101122010a021201111101110111110111100010111110011100110111010011120201222100201220120122b
aaaaaaaaaaaaaaaaaaaaaaaaaaaaaaaaaaaaabbbabbbaabbaaabbababbabbbbbababababaababbaab000112101111111110111111011111111111111101111110111011212122012012102201122122a
111101111111111111011110111111111111110212110021201101002020222200021020102211211011102111111111111011101101010111111111111111011111110200111122012221021220121a
111111011101011011010111101011011110012211102122111211012221202202220122102001021211122110101111111111011011101111111111001110111111011122211221021022200221211b
101101011101111111011111111011110111122110222122201210110020122122212222112222200121212011111111011111110111111111111111011111011110111000012201102210111200222a
1111111110111111110111101111111110011121112011201211112222222121220211212121222122121101111111101100010101111111aaaaaaaaaaaaaaaaaaaaaaaaaabbbaaaaabbabbbb211211b
0111110011111111011110111001011111011222221121011110122122222012200221220122220222022222021112211011110011101100a111011111111111111110111112120221122221a020012a
1111011111111111111111111111110111111002121221102120110200220222222221222222021222222212210212110111111011111011a111101100011110111101121221221201112122a202011b
1111111110011111100111111110111111010202002121201111120102212120201222102012222010220022202121220110111111111111a111110011101111111111011220211222101121b122210b
1111110101111101110111111111011111001200222002112112212122222010220222222021002120212121110022200100111111111011a111111111110101111101122212121221101221b122220a
1111111111111111111111111111111111111211202211222211111111011112222221220022012212222201100021001211111111111111a111111111111101111011100112012211112221a2011110
1111111111111111111111101101111111111002212202012212222122210201101222202102222221202211222001101211011101111011a001001101110111011101121120201122111222b2002222
1111101111111111111011101111111111011111122212221121120102120222220222022021010022222222112111102200111011110110a100011111010111101011100210200212102222b2122122
0111111001111111111111110011111001111202222112001020102022122220002202012211111222221001202121200110011111111111a010101111101101111111001111111111111010a1101111
0111011111011111111111111111111011111111111110101011011122212212012222202222222110102220212211221111111101110110a111011111111011111001011110101010101101a1111110
1111101110101110111101110111010101111111111111111011111111110112102211202210222222002202220102122201111110011101a101111111111101011111011111111101111111a1110110
1100111111111111111110010011111111111010110110111111110101212212001020201022202122011021221210121011111001111001a110010111111111111001111111111111111101a1111110
1111101111111111101111111110111101111111101111110111111011202101111022222122022102220122211221021210010010111111a111101101011111111110111111011111111110a1111101
1111101110011111011111011111111111111111111110111110111102222021112022021122221222212022122222102010111111101111a111110111110110111111011111111001111111a0111111
1100111111101101111100011101011111111111101111111101111111222021221202221211022221210122211200021211111011111111a111111111110111011010111111001011000111a1111111
1111111111111111001010111100101111111111010111101110110112221211222111022100222220222022121210202210110111011111a101010111111111111011101111111111111110a1110111
1101111111110110111111111111111100011110110011111111111101221220112222112212212222102120212222122201011011111111a100111110011111111111111111111111010111a1111111
1111111101111111111111110110111110111111101011011111011112212111201212212222202010222221122022212210111111011111a111111101111111110101011010111111111111a1001101
0111111110110111011011101111111111110111111110111111011111221212210222222212202220222202120222001110111001111011a111011011111111111001111111111111110111a0111111
1011110100111111011011111001111011111101111110111001110110100111010221112212110111021021012111221011011110111111a110001011111111111111111111111111111010a0111101
1111111111110111100111011111111011111111101010110111111010111111101202111110111122122202221222021211111111010110a111111011111010110111101111111111101111a0111011
1110111111101111111111111111111010110011111011011111111111111111111011101110021122111110112110120211111110011011a011110111111101111011111011111101001110a1101111
0110111111110011110111111011011101111111111111011111111111111011111001211212001122200200011201111111011111111110a111110111111111101111111111111111011111a1111111
1011110111111101111010111111111111111101010101111111111011111111110121212120011222202222011222211211011111110111a111011111111111111011001011011111111111a0111111
1111001101010111111101011110111111011011010111111111011111110111111212221221212110011211101222122211111001011001a001110101111111001111110111111111111111a1011011
0111010111010111111111101101111111011111111111111101110111101101111202111021100111211211212111102010111111111100a111101111111111221221111212101212220220a1101211
1101111111111111111111111111011111111111111110110111111010111111100202022122221111121101201012112010111111010011a111111010111111221212121210020111122021b1011011
1101100110010111101011111101111010111011111110111101111111111110101021212222221021011222001020202101111010110111a110111110110012122221112102111222100212a2222101
1010011111111111111111011111111111111101111111111101001101111111111011112002212102122022102210112101111111111011a011111111110011111022022011212201112122a2201201
1111110101111111011111111100111111111100101111101101111111010001001121112102121122111021211021122211111111011101a010110111111111120202101121222022001110a1110211
1111101011101101101101111111110110111100111111111111111100011101111112100122122211120210020211021210111110111111a111110101101111221211112222221201112221a2011211
0111111011111111111011111111110101110011101110111111101110111101111112110022220220022020000022022011111111111101a110101111001012122202110211102122111210b1122211
1100111111111011111110000111111111111110111111011111011111111110111101101101110111110110011110111010111010001110a111101111101112212212020122222101201111a2122110
1011111111100111110111011111111111010110101011111111110111111111111101101111111111011111111111111001011111111111a110001111111112222211022121201210211211a2012111
1111111111111111111111111111011111011111111001111111111101010011111111111111111110111001011101111111011111101111a101001111011100121212100221102122220211a0200211
1010110111111110111111111111011111100111110011011100111110111111111111110010111111111111111111111111111111111111a011111111000111010211112012122120000222b1102211
1111111110111111010011011111111110111101110111010111101111001111101111101110101001110111111111101011101100101111a011011111111111122122210111101000110202a2021010
1111111111111011111111011011101001011101111111111100111111101111111111101111111011101110111111110010110010111111a011011111110110110222112111121220222000a0121011
1111110101111110101111111111111111111101111111010111011111111111100111111111110101111011111111001110110111111110a101011111111112220220111011121002122201b2211211
1111111111001111111111111111110110111111110110011110111111111101101111101011101101011011111101110111111101110111a111110111110111210102201021112220221221b0200211
aaaaaaaaaaaaaaaaaaaaaaaaaaaaaaaaaaaaaaaaaaaaaaaaaaaaaaaaaaaaaaaaaaaaaaaaaaaaaaaaaaaaaaaaaaaaaaaaaaaaa10111111110a011110011111111011120111111112122222210b0200010