131 108
2 1
50 99
107 68
151 17
142 12
37 58
138 64
88 21
4 62
111011001111111011111111111111110011111011101110111011111111100110111111100111110111111110111110011110111111000a111111111111110111021120222121011111101011222211
111011111110111011001011110111111111111011110110111011111101110111111111011111111111001111110111110011111111101a100111011011111222112211111221101211111202112111
111111111110010111111111111110110111101001100001110111111111101111110101010011111111010111101110011111111111111a111011111011101111121121211112202000222220022012
101111111111011101111011110101111111111111111111101110010111110111111111011110011100011111111111111111110100111a101010111101011112211220222222102102222210212102
111011111011101101111111101111111111110111101111110110111110011011111110101001111111101001111111011101111111111a100101111101100122112111122222202222221102222220
111110111111111110001111111111111111111101111111110001011111101111101111110011111111011110111101111011111110011a111111111101111121110202222122222010121022022012
111111110110101111111101010000111111101100011011111110111111111101111111121220222212211202112022120201121101111a111111110110111102022102220022012202110222222020
110011101011011111110111111111101110111101111110111101101011101111111110112202102212022211201011120121210111011a001111111011110121221011221022122000212212221222
111111110111110111111111111011101110111111111101011111111110101111111111111021210010211122022112102121021011111a101110011111111212212211122102220222210221222102
111111101111111011011111111111011111111011111111011111111101101111011011122012102101222001121102010221221111111a111111101111111222222211022120012221012221211212
111110111101111101011101110111111101101111111110111111111111111111111111122200222012222101221101101221211100011a110010101111111122111112112222000221222001222211
110111101111110110111111111111101101111111111101011101101111111111110010101122110221111122221011022220011111011a111111111100101122122011102200220220212121022211
011111111101111111111111111111101011111111110010111110101101111111111111111202111222111121221102020202201101111a011111111011011110120022022222202111022122000011
111111111011111100001110111111111101111001111111000110111101110011111111022111002022121120122021211221201011110a111111111011111220212002221222222001211220211222
101111110011110110111111011011011111111111111101001111110101101001010110110102201222112121102202210112201110110a011110111111110112201112200102102222022220212222
101101111001101101111111001101100111111111010111011101011110011111111010110210212121021101221111210202121001011a101111111111101001212112222000202222210120122202
010011111111111110110111111011011110111010111111111100011111101011111011120122221201222112202111222102021111111a011111111111101212122201220201002221122212221010
110110001111111111111111101111111010111111110011110110010111110101110111101211212122212120211221212221111111111a101001101011111002110221022222012222221210212222
111111111110110111011111111011111011111101111111011110100111111110111000121212021110220112120102100111220101111a111101110011011112022220202200122122121220222200
101111110111010011000101101011101011101111101110111110111111011111101110010022112221211101112221102221201111111a110111111101111112122211110122111101222211212220
1111110011111111111110011011010011111111101111011110111111111011111111111111221212221101112aabbbabbaaabaaaaaaaaa001111111111111111112221121012202201022222112212
1010111111110111111111001111111111111111111101111111100110111111111101111212122022122111122b11220220011201111011111111000010010211220012202201200022212220021112
1001011101111101101111011110110111101110111100011111111111111101111101110112020211012121002b12121212120201111101111111111111111022121020210201222010122011202212
1100111111110111111101101111001111010111011111111100111100111111111111100102121102121011112a11122201112111111011101111101111111022012011221022202202202001222202
1111001010011011111111111111101111110111111011011111111101111111111101111121211112211012220b21211022211201011111110111111000111200222112222222210102020122221222
1111111111101111110100101111111100110111111011111010011111111111110101011211011020112122121b12121101220211101110111011101111111210121112221222122001220122022012
1111001111110111101111111111101110110111101111111110111101111111101101000102122222211120221b20222010222101010111111111111111111220110112122222121122222122122222
1011111111100110010001111111011011111101100011010110101111111111110111111222211122100102021a22121200202011010111110111100111111211121211120202220022122212212222
1110111111110110111111011111111111101110110111111111101111111111111111110112220120012222111a21222121120011111110101010001111011111010111212220210020211122222211
1110111111111111001111101001111010111001111111111111101111111111110101111101020121220222022b12200122011111011111101110011011101011111111110222202122111222202101
1111111111111010101110101110111110111100111111111111111111111111111111111200102211221100211a12112121121111111110111111101111011110111011102212020122112111111122
1111111101111100111101101110111111111011011111111011111111010111111111111201112121101220121a20011122112211111011111110110100011111111110221112122211120122200021
0011111010110111111110111011111111111111110010110111011111111111111101111111110112202211212a21112121021110111111111111011111111111111111112202212111102122120210
1110111010011111111111011111111110111111111110011111101011110101111111111020212222020212110a12101101222201111111111111111111011011111111111011010110111101101101
1111111101100111111010111110111111000111111101111101111111111101111101111221220110112021211a22121101212211011101101101101101101111011111111011111101111100010111
1110111001111111111111101111011111111111111111011111111111100111101110101211201210211112210a12021022221211110111111111111111011111101011100101111000011011001110
1111111111111111111011101110111111111110111011111111011111011111101100010012221111112001112a21210112111111111111111111111110011111001110101101111111111111111111
0101111111110110111111100111111101111011101110111111101110111101111110111110001111111111110a11111101111011111111010101001011111101011111110111111111111100111111
1101111111100011111111111111101011111111011111111111111010110110010101110111011111111111111a01111111111110110101011111111011111111110111111111111011101111111111
1110101111101111111111111011011111111101111011110111101110111111111111110111111111110101100a111111111011010001111111111111111101101aaaaaaaaaaaaaaaaaaaaaaaaaaaaa
111111011011110011110110110011111011011111111110111aaaaaaaaaaaaaaaaaaaaaaaaaaaaaaaaaaaaaaaaa011111110111100111111010111111110111110a1111111111101111111111111011
111101111111111010111001011110111111101101111111011a1101111011111110100111111011111111111111101101011011111111110011011101111111101a1100111111110011101110111101
011101111111100101011110101111111101111110111101011a1111001111111111111111101111100111111111111011011110111101111101101011111011011a0110101011111110110111110001
101111111101111101111112101020022121220222112220111a1011101101111001111111011111111011111111111101111110011100100110111011111111111a1011111111110111111000101111
111111111111111010011121120010200001110211122112221b0111111110101101011111111011101111111001111101101101101101111011110111111111101a0001111111101111111111110100
100111111111101110110120221221220211111121012211122a1111100110111111111111111111111110111111101110111111111111101111111101110111111a1111101100111011111111001111
101110001111111111111120210122110121221120010021102b2111101111110111111111111011111111011111001110111100011001011111111110111111111a1110111001101010111011101110
021121211121122122011122211212211112000222220011120a2111101100111111110011011111011101011101011110111010110001111111101101111111111a1111001111111000111111111111
221212020210211220211100222022021121120221211020022b1111011111110100110111111111111111011111111111111111101111100101111111111001101a1111111111111101100111011011
100010220212211222221120122222220211112222101111222b1111110111100101111110111110111110111111111010111111111101111111111111110212121a2222121202122212212122111101
020112020102211212111102221221022021222021202110120b2111011011101111111110111110111111111111111101111111111111011111111111112220122a1122112202210110011211111110
212120222112221112221122112120221022202210222001201b2111011110111111111111011111111111111111111101111011111110111111111011012121120b2110211202100222212101111001
220110221201122111121111121220212102210221212212111b0011101111111111011110011110111111111101011111111011110110110111111011110212122a1211001111122221022001111100
bbaaabbbbababbbaaabbaaabaaaaabababbaaabaa0212202220b0011110111110111011110111110101101111110211110212102122112102221110210211221202a1101210001111121121202100111
2010221100021101201210012012221221111102b0110020011b2111110110111011101111111111011101111101212222122211222220021212112211121122210a0011221221012001022212111100
1112101210112121222211020222222022011011a1211020121b2111001111111111110111011101010011111101012212221210220120101221202120111211122b1221102211012111221022110111
0121011010222220212211022201020222212122a2201021212b0101110111101110001111110101111010111011200120111111110201120021210010222012111a2201012201212122202102011011
2201011112210121002010202021102200220221a2211100211a2111001111111101111111101111101010111011021000000111111101121000100221212122212a1000222212111111120011111111
1020010221121122210211212212101211200111a2012020222a2101011111111111111011101111111111101111002212111121212201212120110102112111201b2110021122122202101211111111
2221201101122020011210211122122211121112a0002110001a2110111111110111010111111111101111011111001211102212202201101211220221120010212b1110101221112121211111111111
2221200012122011022211211102201202011122b0120120020a2111111111111101101101111111101110111000211022221021021121220121212202210111222b1011200121111101121110111110
2221102210011212100111102122110110011221a2102201012b1110111101011111001011111101111111111111221122011221111221222211221022201212212b0121221020102021210121110111
2001122122221102211211222120021101112210b2020102212a2110111111111110111111100100111111111111010022210222112222222120101121212210122a2021212100122101221012011111
2211010222210012111111101211011220111220a1010102011b0110101111001111011110111111111010110111021120222211122121122110111121222111222a0200210022012111021122111111
2110002221221111011111021122220212021111a1122122112a2110111110111111111011101111111111101101101102102111102122120121112120201212111b1212122021102111022202101111
0221011020110012122111202122110112112121a1222212222a1001111111111011111110110011111110111101220111121011122212121010210012111112022b1201210222111100211221111101
2222012010111211111011110210122210222011a2221112121b0110111101011111011111011111000111111111211211012220102021111111110022111202122a1121220220112020011121111001
0222111221210101220111121110211020211210a2201021120a2011111111111001111110111111011011101111120001200212112212011011212012210122112b1211220121112122222101101111
1211001211012021102210111200021120121122b1201222111b2111111001101111010111111111111111111111210102022012020210210110001221022012211a1212011002212112021222011011
0102212112212211002101111110110100120121a2211120112a1111101111110111111111111111011111110111211212212211221011010220120110100101010b0111211122012111122111001011
1211011110101212122211210201121100211121a2020122212b1111110111111111111111000111110011101101011021221021012020021122101222112102222b1012222020110011010112110100
2221112010121212201200201102212011111121a1222102012a1110111111111011111011111111111011110101022221111112101011222121021121021222220a2002010211221111101200101011
0220200122210112121211122110110110210102a2222212111b1111111111111111010101101111110101100111222212222221222112022100022022202212200b2202111111012102102021111111
abbaaaabbbbaaaaaaaaaaaaabbababbabaabbabbb2212112102b1101000101111011011111101101111111111110222101221222010111022010221102212212110b1122122222010021202220101101
112012122012122012110010111111101110101111110111110a1111111011100111111111011101000110101101002121112212221211121112110111201012120a1210222020221221110221011111
211120221101122112221111111111011110101011110011111a0111110111111111011100101111100011111011212222121212122022021211211120222111022b2101102112011002122010111101
122122122020002011121101111011101101111101111011011a1111111111100111111111011101100011111111122111221201122111001022120102101211202b1212220102100122111020101111
112201021201202201121010011110111101111101111111111a1101111111111111110111100100101100111101011002220222210012202221221121111201112a1220201111201222121111011111
101111110101110111111011111111001011101011011011110a1111111110111110101011100011101011101011211212111222111221212222212101111112112b0012212201222121022112101110
101110111101111111111010111111111111111101111111111a1011001110010110111111000110111101011110211101102011112022121212102102122210112bbbabbbabbbabaaabbbab10110111
111001110101111011110000111110101101101011111101101a110110000101011111111111110111111111110111221222111120210112212121211011100111111101111111011011101a11011111
111101011100111111111111111111110111011111101100011a100111111111111111101111110111111010111122202012122002122100122121220210111111111111111101111111111a11111111
111101111101110100101110110111111010111111111111101a101111111111110111101100111001011011111122121210121002220122221201221121111111111110111101111111011a11111111
111110111111111111110111111101111100111111111101110a111011001101010011111111111101111011111111212102120010221212212211122221101111110011110110110111111a11110011
111010111101001111111111111111111110112101122212222a011222112212211101111111111111010111111111111111111110011111111100011111011101111101011111111011110a01111011
111111111111111110100111111111111102100121010212112a102121121221121011111111111111101111111001011111101111101111110111111111101101101111101111110111111a11111110
111101111110011110001111111111111112101012221012102a121110112210221000101111011110111111111110111111111111111111111111111110101111111111111111110110111a10111111
111111111111111111110111111111010011002022221211201b101221210221111111001011100101111011110101011101110110101111101111001111111110011111111111110111011a11110111
111101111100110111101111110111111111021011012012222b120212121021021100111111101111011111101111110111011111010111111111111111111111101111111011111110011a11111111
111011111111110011101101111110111002211220220102211a111012111112221111001111101111111111111111111110111101111111111001101011110111100110111111111101101a11111111
111110100111101110001111111111001111101111221112122a120111121112021101111111101111111011101111111111111111110110111111111111011101110010011111111011111a01101110
111111101101111111111111111110111111102102110211221a211021102020110111111110111111011111111111101111111111110111110011111111111111111101111111010111111a10111111
001101111101111101010111110011101101021110212211221a121121221212110110011111111111111011111111111111111100111111111111110110101011110110011111111111011a11001101
111111010111011111111011111011111102221210022222002a221111122220121011111111010111011011011111101111111010111010110010111111011111010111111111101110101a11110111
110101011111111111100110111110011011111000011202211b002220110102100111111111111100101011101111111100111011101111101100111101011101110111101111011001101a11111111
111111110011101001111111111111111110122022111101212b001122122211111011111111011111011111111110111111111010111111111111111101011001111110011110111111111a01011111
111111110100110101011111111101111111222122112122002a021212211121221110111011111111011101111011111111011111111111111110101110011111111110111110110111111a11111011
111111111111111111111011111111101110222002110111110a022121222112111010110101111111111111011111101011011111111111111111111111111011111111101111111111111a01111111
011111110111111111111101011000111111211211121201002b201222121012101110101111111011011111111111111111111111111011111111111111100111111111011111110110001a11110111
111001111101111001001111100111000012210200220211102a02212111012121111010011111001101aaaaaaaaaaaaaaaaaaaaaaaaaaaaaaaaaaaaaaaaaaaaaaaaaaaaaaaaaaaaa011011a11111111
111111010111111111111011111010111012120122021011222b11121111011112101111101010101111a11111101111111111110111110111111111101111101111100111110111a010011a11101101
111111111111111111111110101111011110021122212111021b11222122122212011110111111011111a11111011110011111111111111101011111101110111111101111011111a111111a00101111
111111111111111101111111101111110012022202212221221a02221011202111111111111111111111a11111001111101111111011111110110111110111101101101100111101a100111a10101111
010111111011111111111101110001111112212200210102010b22111122212110101111111111111111a11111100011011100100111111111111111011111011111110111110111a101111a11011111
111011011111111101111111111111110110012111221102221a02221110021112110110111110111111a01110111111111101111111011011111111101110111111111111110111a011011a01111111
111111111101101110111111110011011111121220210102201a11012211110001111010101111101101a11101111111001110111111111111101111111011111110111111111111a111110a11011111
111110111111110111111111100111100112121212120212210a11122220122221110101111111110011a11110111011001111101110110110111111111111111011111111111011a110101a11011101
111011101101011111111111110111011111112212202212202a11212001221111111110111111011111a10111101111110111101101111111011111111111100111111011100011a111100a11111111
111111111110101111111001011111101012221111221112122b01100221101200011110111111111100a11111110110011111110111101111011101110111111111111111101111a101111a11111111
111110111111011111011111111101111112202211021210002a21212011111121111011111111111111a01111111111001111111111010111111101111110111101101101111101a111111a01011111
111101111011101011110010101101111111221220001011220b01121221221212111111110111111111a01111110011001110111111100111111111011101010100111110111111a111111a11101101
001011111001111100010011111111101102222221102222010a12221122020110111111011001111111a10101111010011011111110011111110111111110111111011111111101a111111a11110010
011110111111011111101101101101111112212112110021211b11112011201122011111111110111111a10100111011011111110111111011111111111110111110010110101110a111111a11111011
011111010110011111111111110111011112212211010211100a11112222122220101111011101110101a11111111111001001111010011111111111101111111111111101111010a101011a11111111
110111101111111111111111111001110111112122010022120a21102211121022111101011101111011a01110101111011111111110011111111111111101111111110011101101a111101a11111111
110111011111111001111110111111111011111111111110110a11101111101110111101111111111100a11111110111111111010111110111111011111011101111110111110111a111111a11111111
101111011111010111111111011111111110111011111111111a11111111111111101111100101111111a11011111011111111101101111110110111111111101111111111101111a111011a11111110
111110111001100111111110111111110110111111111110111a11111010110101111110101111111011a01111111011111100110110111111111101101110110111101011111110a111110a10111001
011110011111111110000111111111111000110111011111111a10111011111111111111111101111111a11011110111111111001010101101111111111101111001101111111111a011111a11111111
111111111111111111111111111101111011100011111111110a11111111110111111111111111111011a10111111111111111110111111010111111111011111111111111100111a111110a10111011