3 72
151 99
10 83
113 97
55 2
110 70
5 78
88 12
123 67
15 90
11111a10a1111111111110111111011111111111202010201121210121102122212212001112212221001201221222122222221011111101001111a11110110111111111111100011111111110101111
01101a11a1101111110101111111111111100111222211101220221211101021121111010101112011211201212221111012210110111011111111a11111111111111011111111011111111111111101
11110a11a1101110111101011111111111111111022222111212212222111100211212111121122012222112012221122221221011110111111110a10111111100111001110110111111111111101111
01111a11a1111111111111011101111111111111000120111102011012211210221021001022111222101011111220121221220210101011101111a01111001111111111011111111101110111101011
11011a00a1111101111011111010111110110111122112122120120002221212121210211211211211201021111221211112022111111111111000a11111001101100001101111010111101011011101
10011a11a1111011111101111111111111111111110221212201222222111212101221011202102120211212012121222010212211110111111011a00101011011011100011011111111111111111111
11111a01a1101001111111111001111101111001101021211212220002121112101011211012221222112121210211212220110110110111111001a11110110111111111111111111011110110111110
11011a11a1111111110111111111101111111111102120211101110112121011111122211112222121012121221210011101112011011110110111a11101001111011110111011110010101011111111
11101a11a1111111011110111001111111001111011111100102101020210122010000201211012010012222220101211222101211111101100101a00111111111111001110101111111111011111110
11101a11a1111111101011111110011111101100111220112211201210121200222201010110112202201002201112011221212211100111111110a11101110011100011111100111111011110101001
11101a11a0111111111101111111111101100111121210122222101110022122121022101110112122121022202212210201022210111111011111a10110010011101111111010101110111111011111
10100a01a1111110110111111110111111101111211111210120111112122211211122101201122201011102120021101110111111111111101110a11011111111011111111100000110111111111111
11111a11a1111101110111001111111101101011020112222210011211011222111121010211012212212112011121021011120111111011111100a10011111111111111111111111110111101111110
11111a10a1101111111110111101011011011111111212220111101011211111211220211221011000111220210112212001012111001111110101a10111011111101010111111111111111110110111
11110a11a1011111111111110011001111111111220212122222212120121212021122200121011222211122120212211201222011101101110101a11111111011110110111111111010101110110011
11111a11a1111111111111110011110011111111121111121212102200211121111210211010110211212212201021112221221111101011101111a11111110111111111001111101111011010111110
11000a11a1101111101101111100111100110111221122221020122212121001021212110111101111121210010122221121111111001111111011a11111101111000110111101111101001111111111
11111a11a1111111011110011011111011111101002222122202222111022122201021210211120121102210111202121201121111111111000111a01111111101011111111111111111110110111101
11111a11a1011011111011111101011111111101011111111110111010001100111111111221221101110112101211222121210011110111111100a00110111111011111101111011111111111011111
11111a11a0101110101111011101110111111011101111111111101111111111111111100022221001112110201212112121211010111111111110a10111111111110111101001111010111101111111
00001a11a1111101111111111110011101111011010110101110111110011111110011110012112112020122122211211222012211111011111111a11101111111011111111101101111110111001111
10110a10a0111011111011111011101001111111111111001011101011111110110111111012100112201210020222022121022201111010111110a10110101111101110010111111110111110111111
11111a11a1111011111111111111111111010011011011111101111101001100101111101122002021021211112012202022101201110010111110a11111111111111111111111001101111111111111
11111a11a0111111110001111111101111011111011011011011011011110101010111101112121111100120201112100212110110111111111111a11110101111111111101111111110111111011111
11110a11a1011011111101111111111011110111011110111011110111011111111101011121012221211111112011221122212211111111111111a10111101110101111111aaaaaaaaaaaaaaaaaaaaa
00111a11a1111010011111111011111101111110111111111111010110111111111111110111211110022211102220202012021211011111111101a11001111110111111110a1011111110101111101a
11101a11a1111111111111011111111111101111111111111111111110111101111011111122010111122020122120121101122111111111111111a11101110111111111111a1011011110011101111a
01111a11a1101100110111011111110111110110111111011111011011011111111110111211020202102221112212222202202111111001101110a10101101111010110101a1111010011111010101a
10111a11a1111110100011111101111111111110111111111111011000111011111111111110111111111011111111110111111111111111110111a11101111111101111110a1111111000111111111a
01111a11a1111111101101110101110001000101101111111011001111101111011111111011111000011101111111101111111111101101111111a11111111111110001110a1111011111101111111a
11100a01a1001011010111011011111110110111111110011111101111111110111011011111011011101110111111101111111101110101111111a11111111101111111111a0111111111111111111a
11110a11a1111111011111011101111111111011010111111111110111111111101111110111111111111011110111110111111100111101111110a11111111111111111011a1101011011011111101a
11111a11a0111111111111111011011101111111111000111101111111111101111101111111111111111111110110101111011110111011111001a10110111111111111110a1101111111111111111a
11111a11a1111101101111011111111011101011110111111111101111100011110001100111011001111111110110111100111111111011111111a11110111010011111010a0110010101011111111a
11101a11a1111101111110011100101110111111001111110110101111110111111111110110100111111111101111111111111111110101111111a11100111101111110000a1110111111011111111a
11101a11a0111010110111011101111111111111010111111101111101110110111111101111111111111101011101110111111110101111111111a00111011111110111111a0111101111111011111a
11111a01a1111001111111111111111011001101111111111111011111111111111011011101110110111001010110111011111111111111111111a11101111111111011111a0101111011111011011a
11111a11a1011011111111111110111110101111110011110110111111010110110011111111101110111111111111011111110011111101111010a11011111110111111111a1111110111111111111a
01111a00a1110110111111011101111111110101111111111010110100111111101010011101001111111111111101111111111001010111101011a10111101111111110101a1110101111000101111a
10110a10a1101110111101111010101111011111111101111110111011111011111101111111111111110101111011000011111111101111111110a10101111011010001111a1011111111011101111a
11110a01a011101111111110111101111111011111111111111101010011111111111111011111aaaaaaaaaaaaaaaaaaaaaaaaaaaaaaaaaaaaaaaaa11111101110101111001a0110111111001111111a
11111a10a100100111101111011110101101001110111110111111110111111011111111011111a101101011111111011011011111101001111101101111111111011100011a1011101110110101110a
11100a11a110110111110101111101111011111001101110101011111101101001111111111011a111110111101111110101111011111110011111111110100111111111111a1101011101101111111a
01111a11a111111111110101011110110111011101011101111101010011111011111111111111a011111101111111111111101111111111111111111011011111101111111a1110111111111011111a
11111a11a111010011111111111111011111111111000111111101111111111111110111111010a011110111111101010111111011111111111111111111110101111101101a1111111111110011111a
10101a11a111111110011111111111011110110110111111111111101101011111111111110111a101110110111111111011111111101010011000100111111111101111111a1111110111111111111a
01011a11a110111101111111011001111111111011111111111111101111111111011110111011a111111111110010010110001011111111111111011111111011011111110a0110111111111111111a
01111a01a111111111111011111111111111111111111111111110111101111111111001111111a111111111011111110101111111111110101110111101111111111011110a0011111011001111111a
11111a10a100111011111111111011111101111101110111011111110111011011110111111111a011111010111111111111011101110011010111111111111110111111111a0111111101111101110a
01110a11a110111111111111111101111110111001111111101111111011111111110111111011a110111010111101101110111110101111110011110111011011111111100a0011111111111111110a
11011a11a111101111111111111110111111101111111101101111101110111111111101011110a111111011111111001110010111111111111111111011010110110111111a1001100101111111111a
11011a11a011110101001100111001011111111011101111101111111010111110111111111111a111111111111101111110111110111111101111111010011110111110111a1101110111101111010a
11010a11a111111111111111111101110111001110111011101110101111110111111111111111a111111111110011111001111111112101212212011211210021212211211a0111101111100111111a
01111a01a011111111111110111111111111111101111101111101011110110100111111111101a101011110111110111111111001112220221210201121110212120212121a1100101100111011101a
11111a11a111111111110011110111111111101101111111111111001111001110011111110110a101111111011111110110111101111100200021201121201121112022221a1110110100111001111a
11111a01a110111111111111101111111000110011111111111101111010101111111111110111a111110111011111110200212122002022220202222010112101210221221a1111100111111111110a
11111a01a011111001111111001110111111111111001001011110101101111111111111110111a111011011101111110211221222021222122220222222021012222011212a1011111011111111101a
11101a11a011111111101111111101110100111111111110111101011111110111101101011101a101111111111011111100100211202202022200122222121121202122122a1010111111101101111a
11111a11a111111111110101011111111111111111111110111110111110111111001111111111a111111111111111122111222002122221222022222210222121222121122a1011111111110111111a
10111a10a011111111111111110001111111111001111111101110111111001001111111111111a110111010110110121222221221221122222022222211221112111222222a1110101111111111111a
10101a11a111110111111111111111111111001011011111111111010110111110111111111011a111110101001110122111112001121021021022221012221111210221002a1110111011111111111a
11011a01a111111110110011111111111001010011111111101101011111111111000111111111a111110101111100101102012120202210022122212220112001220212211a0011110101111111111a
11111a10a011110110110111011111111011101111111111111011110111111011101111111011a111101111101111122201021120222012201220201222201112100212101a1110110111111111110a
11120b11a122122221111110111111101111111111111111111101111111010111111101110110a001111111010111121021221120022222222011102220222122222111221a1010101110011111111a
21221a12b112110212122100011110111101111111111111011111111011111111111010111011a110111111111011111012221122122202220112100221002012222020122a0111111111110111111a
20210a12b210210120211101100111110110101101111111101111111111111011111111111110a001111111011111102021111222022021220220020210220122022212212a0100111111111101111a
10121a22a201110012222101100111110111111110101111111111111111011101011011011011a111011111100111111211112022222211002222022120021012011210121a0111111110110010111a
11222b12a121112202120111111111100101111101111110111110111101001011101100111111a111111111101111122112002112022222200021222200011212202122101a1011111101111111110a
22212b10a212022201222021211111110011101111101111111010101110111110100111101010a111011011111011122212221111221122222202022222222212012211020a1101111111110011111a
22020b22b122221222222222211111111011111111111111111111111111111110111111101111a111111011101111112222121122212110200022122211222210212102212a1010111101101101101a
02222b20b220022202222022211101111101111101101100111101111111111111111111111111a110010100111111101222102121110212202200202200222112111112102a1111111111011011111a
20222b21a020101112021020001111111111110111111111111111111111111111111111111111a010010111111101101001212221222102022120121222002221122221112a1011011110011101101a
10021b22a202222222221122221111111111011111111011111111111110111111111111101101a110011100111101002001121111211221222222211220221001222211221a1110100011111101111a
00200a11b022222122112112011100111110111111001001011111111110001111111111111011a101011111011110110102021002122020110222200121022211212121001a1110011111111111011a
22020a10b222220221202121211111111111011101110111110011110010111101111101110101a110001111011011111110010201112200220212202021220011100011110a0111111110011111111a
22112b22b222020220222222212212011101111110101100101111111011111111110111111011a111111111110001012021122112202220221222022122122021211120102a1111011010110101110a
22222b12a222122022221020221212111001100111111111110111111111111110111111011011a111111111111111020122221021220022200021202021100111122201112a1011111111110011111a
20212b12b002222222222202201011210111111111011111111111001011110111110110111100a111111111111111122220112112012220201100202220002110201121222a1111111011011001011a
22222a01b222222222220222022110111111111011111111101011111111111110111101101111a111111111100110112021120110122022220022002222220222122112212a1100111111111111111a
22222b22b201212222222222001112211111111111111110100001010011111011101101111101a111111111000111101010112120222221221022220122221202212202112a1111110100110111110a
20110b20b002112102222222101012211001111111111010000101111111111111110011111111a101101111111011112211202120100020100102200121111222210121101a1111101101110101110a
02212b22b021222022222202221210211111110111111111101011101101110111011011101111a111110111111111121111210120112021200222222102212200110110221a1111111100100100111a
22222b22b202221211122221222011111101101111111111111111011011011001111011111111a111111111111111112122220211212210212222112100122221111011121a1111111111110101111a
22222b11b020222120222202221211011111111100001111111111111111011111011111111111a101111011111101102212202222021210222111221211101200111101011a1111111100101111111a
22122b21b120022202112222201211111110101111111111011111111110111110111111111111a101111111000101102211102222222121202222121122002011011111111a1111101111111111111a
00202b22b222220020222211120221101110111110100011111011101111111110101111011110a111110110111101110222211221222212222202002220011121111111101a1101111111111110111a
21220b20b020221222002200221111210111111110111111011111011110110011110111111111a111111001001110101111201210221210121212121101101011111111011a1111111000011110110a
20222a22b222220212222022220020211011010111110110111111110111111111111101101111a011111110101101100122101022112111122122012122022201111111111a1101111111111110101a
20222b21b222220220222122221111201111111010110111111111111111110011111111110110a111111111100110111002212021122120221212110222012101101110111a1110111111111000111a
00221a22b222222122122221111002011101101101111111111110111111111111111111101111a101111111011011111110221122122212202122221121020211101110111a1011111010001111101a
22202b00b222212220202021221111111101010101100111100111000111101111110111101111a101111110000010101102101200211111222121121121221010111010000a1111111110101100011a
01222b00b021222222102021101210211111110100110111101111010011110111110010111011a011101111111111111101210100110222202121221221211011101111111a1101111111111111010a
21222b20b022022222202120022122211111110111011101110111101111110111111111111110a111110110101101011102122122122112201200211111202011110110111a1100110111010110101a
22200b02b202221022211122121102011111110110111111111111111111101111111110010001a100000110111100011011212220211211002211222222011021111111111a1101101110001111011a
22200b22b200222221020202221222011111010111111110111111110110111101111011111110a001010111111111101011211110112201000221122210112220100100011a0111000101110111111a
22121b12b220222022222220222221210111101101011111101110110111011110101111111111a111110110101111011111222222002221202022222220022221111101111a1011101111111101101a
02012b22a202222222220222222122110011111111111111111001110110111101111011111111a111110111110101111121121111011012112010212220221221110111111a1110111111110111111a
22112b12b100222220200222112212011111101100111111111101111101110100111011111111a111111011110110111112121020121112122110110012002111111100111a0001110111111010111a
12200b02b112112222121222222222211111011111111111111111011001111111101110111111a011111110011111101112211120221112012120220222111221011110111a1101111111101110111a
10110b22a211112212010212212222111110010111111111111111111111100110111111011101a110111011111111111011212201102222122001022111202100111111100a1111111111011110111a
21122a01a1111111212112120010110110111111111111110111110111aaaaaaaaaaaaaaaaaaaaa011110111101111111121022020210201022121102202112221010111111a1111011110010011111a
20102a12b1001121102121011021221011111110111101111111111111a01111110010011111111111110001111110111012122202122122210220122201210211110111011a1001111011111111111a
10111a01a2021111122112212222120111010011011111101110111111a01111111100111110011111111111110111110122211012211122201210221222112020011111110a1010111110110111111a
12122b22b1222101102121121221001111111110111101100111111110a11011111111111111010111110111111110111122121022122211220022221222022201101111001a1101111101111111101a
00002a21b1000020212112011121120111101111111111111110111111a01111111110001111111101001111111110110112112101201101121020101212012121011100001a1011011111111111111a
20220a21b1002211222220122211011111110111011110111110111011a01011111101101111111111111100111111111112121012211221222112101211110211111111111a11110110111111111111
11110a10a1101111100111110111011111111010010111111101111111a11010111111101110111111111111111111101120200122110222220112110022011120111011101a01111111011001110111
11111a01a1111110111110111101111001111111110110111111101111a11111110101011111101110111110111011111022121022211102120112121102121011111101101a11111101011111111111
11111a11a0110111111111001110010001110100011111110000111111a00111110111010001101111111111111111111121022001022111011022012120201201101110111a11111111101111011111
11101a10a1011111111111111111111111110011011110101010011111a11000011111110111111111111111011111011102220111112110000222102022200210101101111a10110111101001111111
11101a01a0111111111111111111111111111101111101111111111110a11111111110110110111110101111101111111010021100112001022102220221111211110110111a00111111111010111111
11111a11a1111111110101101110011010111110111011111111111111a11111111111111111111111101101100100110102222120222121101212222222212121111010101a11100101111111111111
01111a11a1010110111110110111111111110111111111101101101110a11111110111110111011110101111111111111121202211221222220212221222222111111111111a11100111010110111101
11011a01a0101111001111111110110111111101101011101111110011a01111101111011101111010111111111111011111111111010111110110101111101111101011111a11100111111111111011
11110a11a1111111011111111101111111011111111111111111111111a11111111100110101111101110100011010111111111111111101011111111111010111111111111a11110101111101111111
11111a11a1111111101111000101011001011011111111001011011110a01111111111111111110011111111111111001000011101111011010110111111111111111101011a11110111111110111100
10110a10a1110110110110111110111010111110011101111101111111a11111110111011100111011111101111101111111111111011111011111101110111111111111101a11011111111111011111
11111a11a0110100101101111100101101111110011111111111011111a11111111100100100110111101111111111111010111111010010110110111111111111110010011a11111111011111101110
10110a11a1011111000111111111101111101101111111111111111101a00111111111100011111110011011111111110011111111111111111111111111011011011011111a01110111000111101111
01111a11a1011111011011101111111011011111111110111111011101a11111111100111111101111011111111111111111101010111110110101111110111110111111111a11111111111110101110