156 96
40 110
76 111
38 70
101 24
119 111
4 21
156 76
141 106
1 95
110011111111111111111111011101101111111111111111111110011111111111111101010110101011110111101111a1010101111111110011111111011111111111110110111a1111111110101111
111111111111011111110111010011111111111110001100100111100111111111101111110011110111111011111011a1001011000111101111111101101101111011111111111a1111011111111111
111111010110110111101011111110001111111111111011111010110100010010110111101101111111110111111111a1111101111011111111011011011111111101111111011a1111111111111111
111111111111111000111111011111111110110111101011111111111111110111111111011010111111110110010101a1111111111101011111111010111111111111111111111a1111111111111010
110101011110111111011011111110101100001010101111110111111111011110100111111101111111111110011111a1111111101110111111011111010111111110011110111a1110011111101111
110111011111101111111111111111111111111111010000101111001111110011111101111111111110111101111101a1111111110110011011111101111011111110111111111a0001111101010111
211222212202121002100011111111111111111111011100011111111111111111111011111011111101111011111110a0111111010111111011011111111101111111101111111a1100011010101110
221020010121222211221110001110011111110001111111111110010011111101111111111111111101111111011111a1101111101111001111011111111010011111111111100a1111011101111111
121002211101112012101110100101111001001111111111111111111111101011111111111111111011111111111110a1101000111111111101111111110111011111001111111a1111100110111011
102222112200221221011111010111011111110110011101111110111010111111111110111111001111000222021112a2120212222211211110201001111111110111111111011a1010111101100110
121011211222121002111111111101111111111101100111011111011111111000110111111111111011110220021110a1112102112220221210210111111010110110111110111a1111001111111101
011221101120220221110111110111101101110110101111111111111111111101111101111111010111111112210122b2202220221122102020211111101111010110110100111a0111111111101111
122111202020121112010010111110011111001111111101011111111101111111111111111110111011112221221210a0120120121220020121010110011111111111011110111a1111111101101011
222212110001222110110100110101111011111111111111110111110111111110000111110111111111111021020121a2010010210210222121011111110101001000111111110a0111001011111011
200210011100200120020011011111111111111011111111111101111111111111111110111111101111011112111100b1122211221202111112011111011111011111100111010a1111111110111111
112122222010122010220010011110111110111111111111110100011111110011011010111010110110111210011222a2222122020202111102211111101111111110101111110a1001111111101101
211212111212122222010110111111110111011111011111101100010111101110011111101111101111012201111102a1102221021121112202101111111110111111000110111a1111111111111111
011122110222020222210110101111101011011111011111001011111111001101101011111111111111110022122001a2212112202112011211110111111101111111100110001a1100111011111111
100122212111112102211111111111111101111110111110111111101111110111010111101111111111011101112111a1200002110212001121111111101111111111110111111a1101111011001001
221210111212222212211110111111111001111111111101111011111101111111100111011111111111101022111122b20112212220021202221111101aaaaaaaaaaaaaaaaaaaaa1111101011111101
012120222022112111121111101101011111010111110110011111001011111111110001111011110111110122122111a11202210121001100222110010a111110101110110111011111111111101101
210112211122111202211110111101111111101111110111110111111111001111001111100111110111111101212110b12220012011002212011111011a111011111011111111111111111111111011
bbababbbaaaaabbaabbbaaaaaaaaaaaaaaaaaaaaa1111111101110101111111111111111111111100111111201122201b21212121221011211212111111a111111111011101100001111111111110011
2121021220002022212111100011110101111011a1111111111111001111111111101111111111111101111100222221a10122012211111010212101111a101011111111011101111110111011001111
1100121002211111110111101110011111101111a1111011111111111001111010101010110111111100002102001010a11111222111121022121011011a010011111111111111111111111111001111
2122122201221222101111111111111111101110a0111111100111111001111111111111111111110010110111222021a01221112120222222102011011a011111111111111111111100110110011011
2100121121202021112111110111110111001111a1111111101111111111111111011111011111111110112121011221a11021221120222220111111111a111111101111111111111011111111010111
2210211122212121212001110010111111111011a1111111111010101111100010111001110111111111111210122111b12001112112011111111110111a110101111011111111111011111011111111
2222121012010122112111110111101110000111a1111100110011101110111111110111010110110110110121212222b22200222201121101012110111a111111101111111011100110111101011111
1122010212121112112211110111111111111111a0111111111111111011111100111110110011111101011102121120b20101112110112202010111111a111011111111110111111111101101111111
0121121110122110210111110111111101111111a1111001101010111101101001111111111101111110111122122212a12212202220122221221101001a111111011011101111101111100011111111
1112221100021221222010111001111101101011a0101111110011111111111100111011110111111111011012221002b11112112020122111110011111a111111111111111101111111111011110111
2021221121200122221111001011111111111111a1110010111100111000111100110111110111111101100210211010a11222121111122121210100111a001100101111111111101001111110111111
1100221121112211022101111011110111111111a0101111110101111111101110110101011111110101111122021121a21222221212201221010011111a110111100111111011111101111111001011
0211010221221021212001111011111111110001a1011101001111111111111111111101100111111001111120000222b12211211211211002121111111a111101111011111111111011011101010111
1211211212112012020211110111100110101111a1011111111011111110010101101110110101111111112111211120b11212002012210221112111111a111111111100011111011011111111111111
2212011022112211212010111101111110111011a1111111111111111111011001111101010110111110012112112012b02122122021211102210011011a111001100111101011111111110011011011
1111111001101110111011010111001010111111a1111111111111110101111011011111111111101111111122221101b00122222202211102121111111a111101101111110111111110011111100111
1011111011011111111111101110101110111111a1011111111110011111111111111111110101101011110221020211a01101202210221012210111011a111111111111011111001111101111110111
1111110110110101011111111111011101101111a1111011111111011011011111111110111011111011011212221122b01011121222111222211011110a111110110110110011110111111110111101
1111011111111111001110111101111111111101a1111101110110111111110011111111011101111101110111111111a01011110011111110111011111a011111110011111111110011111101110111
1111110111111010111111111111111011111111a1111111101101111011111111111101101101111111111111101100a11101011011011111111101101a110101101111111110111011111111111111
0111110111111111011111101111111101111111a1111111010011011111011111000111011111110111011111101111a11111111111011000111111111a111101100101111101111111100111111111
1011111111110110111010001110111111111111a1111011111111110111111111111011110111110111111110001101a01001111111111011010011111a110111111110110111010111101001011001
1111011101111111111111111111011011001111a1101110111111101111111101110011111011111111111111110111a01111011111111001111111110a111000111111011010111110101011111111
1010111111110111110111100101110111110011a1111111011101111011110111111111011111111110111111111011a11110011101111111101111110a101111111110111101010110101011111111
1101110111111011101011111101111011111111a1111101111111111111010111101111111111011111111101110111a11111011111111111111111111a110111111111111111111111001111001111
1111101101111110101111110111111111100101a1101111001111111011001101111011001011111111111001011001a11111101111101111111110001a011111011101111101001110111101000110
1111111101101111111111101110011111111111a1010101111110010111111011010101111111111011011111110111a11111111111111111111111101a111110111111111111110100111111011111
0011111110110111111111001101111111110111a1011011011111111111101110111110111111110111101111111111a11101111111111101111110011a101111111111111111111011111111111111
1111111111101101101111111111101101111111a1111101111001011111011111111011111001111111110111111101a11101001111111111110101101a011110111110111100111011111111111111
1111110111101101110111111111011011111110a1111111111011111001111011111111010110011011101111110111a11111100111111110011101111a111110111110111111111111110111111111
1110011101001101111111111111111101110110a1111011111111111011111101111111111111110011111110100111a11111111110100111111011111a101111111111111110101111111110111111
1111111111111101111110111101101110011001a1001111110110001110111111111011101111111111011110110101a11111111111101011111111111a110111111111111111111001110111111101
1111100100111011001111111101001110111111a1011110111111010111110111111111100111111111111110000111a11111011111110011110111110a111101110111110101010111111101110111
0111111101111111011111101211001021211222a1211220122210111011110101111111111110111110101111111111a01111111101111100111111111a110111011111110100101110101111001111
0000101111110111101111101111221110022122b2111110102020101110011011001111101111111010011111111111a11101110110010111111110111a101110111111111111010011111111111111
1111111111111111011110111220021122202111a2122121122112111101010110111101100101010111111111111111a11111111111011010111111110a111111011110111011111100111001111111
1111100111010101011111112121120111111121a2201001001222110111111111111111110111111111111111110111a11110110011110111111111111a111111001011111111101111111111111110
1111111111111011111111102221102202111221b12120122212221111011110101111101111aaaaaaaaaaaaaaaaaaaaa01111110110011011110010111a111110110110011111011110111111111111
0111111011110111111111121122221110111212a11221111101011111101011111101001111a1111011101111111011110001011111101111101010111a101011110111111110111110011101111001
1011111111110111111111102122221012002202a12211101021101011111010111101111111a1011101111011111111111111011111111111111111111a101011111111111112021221121011220211
aaaaaaaaaaaaaaaaaaaaaaababbbaaabaaabbaaba21112012102201101101111111111111101a1111111111110101101111101111111111010111111100a111011111111111112011212111220212011
1111111101111110011111101112021021212002201102221211121011111111111101111110a1110111111011011011111101110111111111001110111a011111101001111012112101111122121202
1001101011010101111110112122121110222212020120011222011111111110111111000111a1111111011101111111011011111111111011011101110a111111111111111112101011122211001121
1101111000111111111111112011221012222221221112111111211111010111111101111111a1101111111111101111011111010111110110011111111a110101111111110102210101111202210212
1111110101011111111111122222111112221211122202112022201111110101111010111111a0111111110011111110110110111111101011111110001a111110111111111111012120200212112111
1101111111110111010111121002202001210211122211112102200111111111111111111110a0101110011111001101011111111101111111111000111a111001110011111110022221222222111012
1111111111011111011111021222020221212021002212022221021111101001111011011111a1011011111111101111111111111111110111110111011a100010111111111112201220102211102112
0010111101101101111110122211201012222111221211200120111101100101011100111011a1110111111111101110111111111111011111110111111a111110110111011112212212110212022001
1111011011011010011111110201111210122012121121111011101110101011110111111011a1111101111111110110110101010101011101101101011a111111101111111110022122101011202220
1011110011011111111111122222011121222211221001101122120111110111111111111111a1100111101101011101111101111101111111110011101a111111111011101011211100221121020222
1110100011111111111110022022211011212211202121012211111111010110111111111111a1110111011110001110111011101111101011111101011a111111111111111111222111221211202112
1111111001111111111110102210021022222111111111112221110110111111111111111111a1001111111000111110111111111101110110011111111a111101111111111011102121222120221120
1111000010111010101111112222110111012012211212111121121111111000111110111011a1111110111110111111111011111111001111111101111a011111111111111112012000011111122222
1111111111111111110010122110220112122020111212200121211011111111111101010110a1111111111111111011101110111111111111111111110a100111110111111112120122122121112221
1111111110111111111011111200221211102221220202122121111111001111111100111011a1111101111110011011001111111101111010110111110a111101101111011012121110111022021112
1010101111011101111111110221202100211120102021212212101111111110111101011111a1011111110111111111111110110101110010111110011a101110011111111102112110102101021211
1011110111110111110111100222022220012122122122212122200110111110111111011111a1111111101111111110111111101011111111011101100a111100110101100110211111112211221211
1111111111101110111101112201112222102122121120211101101111111100111111110111a1101111111111111011001011111111101111101111011a101111111111110111121122022111012221
2210120121201212111101101001222001110111211211121001011111111110111111011111a1110110111001111011111111011110111111111111111a101001111101110111101202222222122221
2021101010222112011111021112101020020022112211111211201101111101111111111111a1111110011110101011101010010010101011111011110a111111101110111111111202200110111221
2222121112221212011111111122220201122022211100212021021110000001111110111111a0111011010110111101111111110111011111111111010a111111111111111011221211210111211222
2021100102112202011101112210211022211111000100112112111111101000111111111111a1111101111111101110011111111111010111111111111a000011111111001110221112001210221212
2000122122221111111101021222221211020120020120222022011101111111001111111100a1011111111011101111111111101111110111001111111a111111111111101112201010101100112121
1011222122021111111111111021201221112222210120012220111111111111110100111110a1111101111111000101111111110111111111011000111a101111111111011112101121012111110102
0211122020022112211111011111111111111111111111101110111111111011111111111101a1111011011111111111101111011011111010101111111a110110111111110111012101211122211110
0211022210110221011011110111110111111111111011110100111101110111000011011111a1111111001111101001001101111111011111111111111a111111110111111112201201201122112021
0221110010020110211111101011011110111110111001101111101110111111111111101011a1111111001111111110111110101001111110111111111a110111111111011100002111122211012221
1221212002111121211100111001111111011110001111111111111111110001001111111101a1111110111110110111111111101111111110111111101a010110111111111001200222202201201211
0112221111102022100101011101111111111111101110101111111111111111011011111111a1111011100101111011111111110011111101111111111a111111111111111110121112211020201101
2222112201011111011111100111111101010011111101011011111111111101011111111111a1011110111011111111111111111111110111101111111a110001121101001110022222222211210001
2020010221121201110101010111110111110111110011111110010011111011011111111111a1111101111111111011111101111110101111111110011a112010020212021122021122010221211111
1011112021010200011011111111110111111101111111111111111111111110011111101100a1111101111111111111110101111110111011111111011a112221010220202111211111021202101111
2112210202222002111110101111011111011111011111011101111111111110011110011111a1011111101111011110111111111010000111111011111a112210221101120112111212121201121011
0112220222022111101101110111110111111011111111110111011111011111111011101111a0111111111101111110101111111101110011011111111a012111110120212211110122222101011101
1110212211112112011111110111011011111111111111011011111111101022112112220010a1202022201012211111111110112011001121120220220b010222212200012011201112110001211111
2212001220111122211111011011101110111111001111101111111111111112012220112020a1212122202122221110110111111011111211221221221b112022210222021121220112100212111110
0222212212222220011111101110111111111110011011111111111111110002122121110121a1021112222111220101101011102001111101122102212a111012121122112222122102102102212101
111121121011110110110101011011111111100111011111110aaaaaaaaaabbbababbbbb1202b1101111212111211011111111101110011021022001121a122201221220222110111121111100122111
212111222122222110111111111101010110101011110011010a1011111112112122201a1112a0212222112200211101011011001112111022111111220b220122211201221121221211111000122111
121222012121221101011110101010111111111111111111110a1101111112112211221a1211b0101121211201211011011111012111021202222011200b112222222202100101110121021120122111
222110200111212101111111011111111011111111111100011a1111100111220221212a0102a1121202211122121100111101112220221221200121220b200221212201111212101101122121212111
222211101111022221101111111101111001111111101101111a1101110112120102012a1211a1121212112011121111111101111010120110012121222a122211222120221200121121112022011111
211002120202222221111111010101111110111111111011011a1111001111110221210a2200a1212201110112201011111011011210112211010212112a211122200211220210211201022120212111
020122121111221021111010111111111111101011111111101a1111011112012101121a1010a1122002202221111110111011002212220111121211122b212020022211122202000111102011112111
021111222121210121110011111111110111000111011111111a1010011111112002222b2021a2011211120212111111111111011212201121121211111a022210201202012221120220122022212111
220111222120201011111111111101111110111111111111010a0010111112122110221a1210b1212121022001121100111011111212122121222101221a202022220022122111122211122202121111
201210221101211111111101111101110111110110111111011a0011111100201210111b0101b2110212000112001101111011012110012121112110102b212201222222012121101202211112121110
100112012002111211101111111101111100011111011111111a1111111112011201122a0102a1021102021212021111110111111122112201211201211b121102212120001121022222211121120111
122211222020211211011111111111110100111111111111111a1111101112222122112b2021b2212211220021010101111111111112102210112222121b122211120122022102021102100221212111
111111111001111111101101101111110110111001101011111a1111111102120111111a0211a1120220211202201111111110110011012121201121201a220202222210201200112002212212221111
111111011101111111111011111111001111111011111011111a1011111110112110212b2111a0220202011122010011110111112000210211221122100a220002020120221221221112222122212111
111110111111111110111111110110010111111111111011111a1111111112221111122a1212a1220012122212110011111101110222222202112112112b120222210201120122012211012222221110
111111111111001111101101101111111111110101101111101a0111111112201212210b2112a0121012102022201110111011112220221112202212021b222210222221011121211020222222112111
110110110011111110111110111111011111111111111101111a1111111012201110011b2212b1011212012121100111111111011111111212110120121b121220212001001010122200211122101101
010111011111101111111111111111101111111111111101110a1111111101222110112a2011a1012201122111021101111010111110211211122122110b122121102212022212122222220202220111
111111111111101110100111111111101111111011011111101a1111101011102120011b1012a1020122001011120111111110111012021112202120020b021111222121221102000012201121120111
101010111110111111101011111101111111111111111111011a1101111111121220120b2111b2211102101011211111001101111112222201122110000b121022222122122221121120100101111110
aaaaaaaaaaaaaaaaaaaaaaaaaaaaaaaaaaaaaaaaaaaaaaaaaaaa1111010102022221122a1012a2012221100210121011111011111010020102011112221b222102222021110012212111120222102001