141 3
4 116
102 41
139 49
84 34
50 4
29 64
116 7
144 64
35 51
1111111110011111011101111101111011101012a110221001221121012122121111111011111a1111110111111111111101002220211212221222100021022211220111101011100010111110111111
1110111111111111110111011111111111112100b121211211222210101122121010111111101a1101111111111101111111112122122121212022102202222121121110111111111111111111110000
0101110110101101111111011101011111012221a112111212012210211122120211110111111a1111111111011111101110102222222111220101210011222212021101111111110111011101011111
1101111101011110110110111100101111111222b221222011002022000201111211111011110a1111111001111110110111020121102111111120222222210101210111011101101111111111110111
0001111101101111110011111111001111011121a011220012111201222122210110111101011a1110110101111111010011111121121201112012102121200010021101111110111111011111111111
0110111111111111110110100111111111022112b021210210022221101102122111111111111a1001111111110011111100102211111212221211121201112121211101110111110111111110111111
1110101111111111111111101101111110121102a222102111222012211202022111111111011a1111101110110111111111112000021112102111010111121212101111011111101101111011111110
1111001111110011111111011111111101112121b210002102102101212022221211011101011a1111010111111111111111010221102220110101210212221200221110100110010011101111111111
0111110111111110111110111111010111122202b210021211121122111110202211111111111a1111111011111110111111112122212222020222222122120110111110011100111111101111111011
1011111111111111011111111101111101110122a221121201201021022121122201111101111a1111011111011111111011110112200222210212122201212022111011111011111110111100110111
1111111110111011110011111100111111111202b002212220022102102212220111110101111a1110111010111011101011111102012101111220221211122120001011010111110100111111110111
1001111111111111110101001011111111111211b221101222200101111210101210111011111a0011111011111011111111122221110121221112120211111122001111111111011101101111010010
1100101111111111101101100011111101122120a222012221120202102220102211011111101a1110011111111011101101122201120122122222122111112022211111111011110111111111111111
1111110111111101111101011111111111120110b211012021211121220201011111111101111a1001101101110111111111102222120012211222211111020221111011111111111111101111111101
1110101111111101011001101001111101100220a022112121220112012112202211011111011a0111111111110111110111112110122122012222101212222022111111111111111111111111111100
0111111011110111111011100011101111121122b122221122200112121111001111111001101a1111100111111011111110122212120012202222102202222222011110111011111110001111111010
1111111101011101111111101111110111101100b111221222110220120121212211111011001a1111111011111111011111122200212212021112122201220120111011101111111101111010101111
1111111110111110111110111011111111100102a211201120122111120210211211111011011a0011111011111110111111010222021122211221022222111121021111011101011111111111111101
1111111111111111111111101111110101101221b222202222212122212010002210110011101a1111110101111111000111121021122221122121210222221221211110101111111111011011111111
1111101111111011111011011111111110121221b212121220011210112210211211121122111b0111111111100222110021112101220221212222121222021111201111111111111111100111111110
1111111111111111111111111111001111110111a111101111111101111111111101112001212a2201220102211112222222102102221110222111022202111222210101111101101101111110111110
1101010111111001110111101111111011110111a111010000111101011111010010122020112b1112112112121222221221120102120012210112112120111220121110101100111111111111101111
1111011011111010111111110111111100010111a111111111111110111110111111112022222b1120112121222221222202112211000112212100201122012101111101001101100101111111111111
1100111000101101111111111111111111101111a111101111101110011111101111120212112b1212221121121222221202011001111011111001111111111100111111111110010011010001001111
1101011111111011111111111111111111111111a111111111111011111011111111122221101b2222112111202111200212110011111111111111111111101101101001110011101111010111111111
1110101100111011111111111111101111101111a111101011111111111111110101122112222b0102121121211110121201101101111111010111111110111111011111111111111101111111111011
1101111101111111011111011111111111110111a001110111110111111111111111122220120b2212211110002210122210020200022220012122101011110111111111111111110110111010111101
1111111111111111111111100110011111010010a111101111111111111111110111101011212b0111120112220022012221111211221211102111110111001101101101011111111110111111010011
1101111101101111111111101111111101101110a101101111111111100111111101122211211b1121121102122222020220122111122121110121111111111110111111011111011111101100001111
0011110111101010101111011101111111111110a111111101111111011110111011022220111a2110112222122122212022201010221221110122110010011111010111111110101001110110101111
0111111111101111011111111111111111111011a011001111101110111101111111101122120a1111212112000112210020200221121222002011111011111110111111111111111111001111111111
1111111111111110101110111111111111111111a101111110111111110101111110020111122a2102211122202221212002111221012211121112011111101111111111111001101110101101001101
1110100111111111111011111001011101111101a111000111111110111101111111011111012a1220120222211222220212222122011201120011111110011111111011111111111111111101111111
0111111110111111110110101101111110110011a110111111111111111111110011122021222b1012101122212211012222222210111222110122010111111110111110110111111110011101111110
1111101101111111111011111111110110110101a111101101111111001011011111111112210b1011222002120122221210112202210001111112101111111212121221122112122100110121111001
1110111111111111010101101110001011111111a111111101111111011011111110112210210b1112212222202022202122121011111011212210111111112222221111202120111022201022211111
1101111111111111101120110121222120210222b212111212011110101111111010120212121a0122112112222212122212011010111222122222001111211022111110022002212020110211011110
0011111011101111111122121012121121021122b112101021110111011111111111112102102b2221221012222122202210022011002201211112111111120221221210211212101021102022110111
1011111111110110111122021121120110012202a102210202201111111111111011111221121b1120022221012020012222222102201212000101111011110110222222112012002122222111111011
1111111111001010110122222101121121011021b201121121211101110110101111111202021bbbbbaaabbbbbbbbbbababbaaaabbaabbbbbbbaab111111221012111202120022112112101221211011
1111111101111101111120112222121210101012b2021212212101100001111111111010221021211211110012112222222221121012022211212b101101222222212010201211211121012112201111
1011110111011111010122122010220122002021b1212112200111111101111110001200111202112021201022212112112202102021021102121b111110101022212111121212021210222121111111
1110011110110111101110201120112102212221a1211211222111111111111101011102221121212112102212220202222200120211211121010a011111210101022122200122210222202202211110
1101101111111111011112020220212222012212a2212220112111111111111001111110111201221012211220010202222100211222021112212b111110221221111221121201022221120021111111
1111101110011111101112002211112221111110a2201201022110111111111111111212101221211222111000122112222221111121001222021b111111111102110210122200022222221000111111
0101111110111001110122110221121111121120a1100021022111011010111010110110112201222221112221001020121212122102102221011a011111112201211210110221121211211011011011
1101011111110111000021220012221221122022b2202022011011111111111011111121022102110102210102222202121102220221211121001a110111210021222221112201122102211122211111
1111111101110110111021121001122222121220b2111111212011111101111111111021222100022202022211222021222221112010011222000a010111012102221211002120111121122111100110
1111111111111110010122022211221221110010a1111212121101111111111111101012212200121122221222021112121210211112201021021a011111211222112121022210222112112020111011
1111111110100121210021220020221022202221b0210221022111101111111011111111221022121122101022210221221222111012122110221a111110101122212220202222222222022220120002
1111110110001021121120220122121220012020a0222110112110111111101101111101110011111111111202011112001012201102011210222b111101112122222100222122210110022212220001
0110111111111012120210000022222220121211a2222122221110111111110111111111010110111011111022202122101212122011221211210b101111211122000222212200222222012022211202
1111110011011102111222112221200022122212b0222010210101101111110111111111001101011101101021220112122112112212112011101a101110221111211222102220022220102202210222
1010111101100002000202122221110112221212b0121220121111111110111101100010110111011111110111121112212121222222121221220a111111111212222222220212022222222102221202
1011111111111112210112210222010202002210b2100021212110111111111101111101001111011101110122221212011210022221211220102b101100202220202000220222201222212122211022
1111111110001100112011102000111222202221b2212221221110101111100101101110111111111101111210102212011201100021112100122a111110101122122021122112221022222101222120
1101101111110122221021122121122220202222a2221221112110111110110110101111110011111100011201212220020221221212102110211b111101121110102201022222122122202022211011
1011111111010121101120202121200222221222b0211020001111001111001110111011011110110111111111001111111111001111111111110a001011221222222102101212221111002022212110
0011111110110112222012221220120102002222b2122221202101111111111101111011111011111111111111011001011110101110110111101a111101212220222220220011220210022221110121
1111111011011111121102122120212222222222b2222021111111111110111011111100111111010101111011110101111101101101110111111aaaaaaabbbabbbbbbbbbb2022220102121200211212
0111111001001000112202212122220122120222a200222020011011111101100111111111011110111110111001101110111101011110111111101011112002022202022b2212002110111110211212
0011110111011111101122020222012222222112b221212022211111111111110110111111101111111111111011100111111111111101111111111111112121221220202b2102222111122122212120
1111101111111010102222120022121222221212a221212222111101111111111111111010111010100111101111111111111111111111011111111111111112220021002a2222222211111220011210
1100111001101112211102212010111212020210b202210120211111110010111110011101101110110111110111111010110000110111111111011111112221122122202b0220222100021220202110
1110011111111022122222201220221221202022b202112122211111111110011011111111010110011101110111011001011011111111111111111111112221111122012b2122212221020021112111
1111100111111110221000212120221021220212b220221110111111111110111111101101111101111011111111100010111001011011111111111111011111112112122a0202121210121021121220
1111111101111011112121212102011221222110b222221021110111110111101111111001111111110111100111111011001110110111011001111111010110110221212b0110212122212010212122
1110111111110110110122202001222111212120a020210101111111111110001111101111111001101011101011101111100011111110101100111111110111111200021a1112111021221101112112
0001111111111022212212201110201212102111a001110111101111110111011011111100111111110111110111111111111110001101111110110111111110112211121a2122122210110112021211
1101000111110120122111022211001212121000a012211101001111111011010111111111110101101111111101101011011110111111111111111110111111122110002a2101111021021222120121
1001011111111111101222210221020221100202a112211111101111110111111011101111111111010101001111111111110101100111111000011111000111111112121a1111110021121111110102
1111111111101100212201220111212222221121b111010111111111111010011111111011111101011101011101101111110011111110100110101111011111112100100b0122122211111222201020
aaaaaaaaaaaaaaaabbaabaabaaaaaaaabaabbbabb020010110110011111111110111110111111111111111100110111111101101111111111110011111110111122120201b1022100211222212122222
01101110111011111110122122212111222020122001111110011110110111111001011111111110111101101111111111111011011101111101101011000111021012211b2122220212222120121112
01111011011111201221012110122021211220121111110101111111110111101111011010010110110111111111001011110101011111101111110110011111022221210a1211212222120222022122
10101100001100212111222002222111121210221222011111101111111011111110110111111100111101110111111011101111111110111011111000111111111021100a0121221221122120120201
11000101100111210221122121022112220122201012001111111011001101101010010111110111011110011110011111111111011110011111111010111111022022221a1211120211021112212221
01101111111111210211202122000201112201222100111101111111010111111110111111111111111101110110100111111111101111111011111111110111122121101b0121011221211001212111
01111011011111112121012120212222212112100201011111101111111101100110111111111011011111111011011110111111101111110110111011111111121021102a1112200210111121210120
aaaaaaaaaaaaaaabaababbabaaaabbbbbaaabbbbababbaaaaaaaaaaaaaaaaaaaaaaaaaaaaaaaaaaaaaaaaaaaaaa1111111111101111111111101111011111111011022200a1012212022002110122212
011101110111111111111111011101111111111111111110111111101111010101110111011111100111111111a1111111110111011101111111111101111111011111111a1111101111101111111111
101111111011111101100101111111111111111111111111111101111111110111111110011111010111111111a1111111101111111101110111111110111010110101111a0111110111111111111110
001111111111111101111101111110111111100111111111001101101111111011111111110010111011100111a1111111111101111100011111111111111101001111111a1111111001001110111001
111111101101111111111011111111011111011011101101110111011101111111111101101110111111000110a1101111111111111111111011110111111111011011111a0110111110111111101101
111111110111111111111111011111111111111010101101111011100111111111011111111111101101101110a1111111011111111111111110111111111111010111110a1111111110010010111111
111110111111001101101001111111110011111011111111101111111011101011111010111101111111110111a1011111011011111111111111101111110111111011111a0101011111101101111111
111011111101111111011111111111111011110111101111111011110111111111111111111001111111011101a1110101111111011100111001111101110110111111011a1111111110111101111111
111111111111110101010111111110100111111001111111111110111110110110111100111101100110101111a1101011110111101001111111110011101110111101111a0111010111011111101011
111111111111110001111111101111011111110011010111010111010110100111110111111011110101011111a1001111111011110110111001111000110111111111101a0111110111111110111111
111111111011101111111110111001111101110101100111111111111011110011101111011101111110111101a1111011110011101111110111111001101111110111011a0111101111111101011101
111111111111111111111111111111101111010001111111111111110111111111101111111011111111111110a0111111111110111101110111111111111111111111111a0001111011111010111111
101011111111011101111011111000010101101011011101010000111111011111111001111111111011111111a0111111111111110111101111111111111101011111001a1101011110111110111111
111111111101111111111001111011011101101011110101011111111111101111111111110100101011111111a1011110111111011011111001111111111101111101110a1101110101011111011111
111111111111111111111111110011011111011111111111011011111011101111111111001100110110011111a1111011000111101111110111000111011111111101111a0111101111111111101111
111011111011001111101111001110011111111111001111111111011111111111111111111110111110101010a0111010111111111011111111100111111110111111111a1111011101110111101111
111111011110111111110111111111101111111111111111111101011111111111111111111111111111111110a1111111111111011010111011001111011111011111111a1111111111111110111110
110101111010111011101101111111111111110111111101111001110111101111011011111111101111111110a1011111101000111111001111110111111111011111000a1111010011111111111111
110111011111101111110101110101110111011111110111110110101100111110111011011101110111101111a0111101011111101111011111111111101111111111110a1111111111111011010011
001111011111111111011101111111100101111110101011111111111111111110111111101111110110111111a1110111111111111001111111111101111101111011111a1011100111110111111111
111001110111001111010001100101101011111111101111101110111111101111000110111010111111011111aaaaaaaaaaaaaaaaaaaaaaaaaaaaaaaaaaaaaaaaa111111a1110110111111111110111
0011111111111111111011110111111111110101110111111111111111111111100011111001011111011101111111011111111111011111111111111111111110a111110a0101111001100111111100
0111101111110111111011111011111111111111001111111101011101101011111110110111111111100111111110010100111111111111001111011010111011a111111a1111100010110111011111
1111111111011101101111100001101101111111011011111111111110111111111010111111111101111111111111110111111111111111111111011111111111a110111a0101111011111011111111
1001111111011111111011111110110111111111101111111011010111010111110110111101111001101101111111111111111011110101100101110111111111a101111a1110001111111111111101
1100101011101101101010110110111111111111111110111011001011011111010110111111111111001111110111111111011110101111111101111111111011a110111a1011101111111011111101
1011011011111010101111111111101111110111111101110111011011000110111111111111111111101101101111111010000110111111110111101001111111a011110a1111111111111101111011
1111001101011011111111111110001111111111101111111111111011110101111011101111011111110111110001111111101111010111101011110110101111a111111a1110111111011110111111
0111111101101100111011011111100101111111101110101111111110111111011110110101111110101110101111111100111110111111100100111111111111a001011a1011111011101101111101
1111111110111111111111111110111111101111001110110111100101101111111011110111111111111111111001111011110111011111001111101110111111a111111a1101110111111110111101
1111100101101111111011111111111111101111111111111110110111111101011110111011101111011111111101111100111111111111111011101110111110a011110a1110111011111000110101
1001101111011111011111100011110101110010101111111110111111111101110110101111111110111111111011111110111110111110101010111111001111a111111a1111110111111101110111
1111111011011111111011010111110111100111111111011101111111100111111111011111100111010111111110101101111111111001110111110011100111a011101a1110111111111011111101
1110111110111111110111110111111101101111101111110011101111101111111111111111111111111011011110110100011110110111110110111110111010a110110a0111111111111011111111
0111111111111011011101101111111111110111110111111111111001111111111111001111111001011111111111111111111111111110111111110111111110a110011a1111110111001111001110
1111001111101111111111010111111111111011110101011111111111110101101111111100111111111111111111011111111111111111010101111111111111a111111a1111111111111110111111
1111111101111111111101111001111100100111111101101101110111110101111101111110111011011100111111111111111110110111110101011110110110a011111a1010111110111100110111
aaaaaaaaaaaaaaaaaaaaaaaaaaaaaaaaaaaaaaaaaaaaaaaaaaaaaaaaaaaaaaaaaaaaaaaaaaaaaaaaaaaaaaaaaaaaaaaaaaaaa11111001110110110101011111111a101110a1111101101110011111101
1011111110001101110111111011111111110011111011111100111111110111111111101110011110101111111111110110a11101111111111111011101110111a111110a0011011010111111111111
1111111111010111111111011111101110111111111111100111111011111110111111111111111111101111110010111011a11110111101111111100111111111a111110a1011110111110111110111
1111111111101110111001011011010111100110011011011111111101110111111111101111111111101011010001011111a11111101110111111111011101011a111111a1111111011111011011000