13 113
2 6
159 6
37 17
12 58
100 77
10 53
130 47
107 79
19 43
0111101111111101101111111111111111111111011111111111010111111101111111111101110011110111101111111010a11111100110111001111101a11111101111111111112000002122201000
1111011100011011111111111111110011111101111011111110111111111001011111011001001101111011111111111111a01111111111111010111001a01111111111111000012221111012111201
0010111111111111111011222002212102202001201212201012011111111111111111111001111011011111011111101110a11111101101011111111101a01011111011111111002211111121121202
1111110001010101111101021122101021211121120210000220211111110111111111101111111110111101011101111111a10111011011111011110111a11100101010111011111221210121011011
1110100111111111111010000101111121212020201211211111201011111111111111111111011111100101111100111111a11110111111101101111111a11111111110011101102021211100020112
1111001111110101011011212121021111021222112021002111111111101101110101111111011111110101101001111111a01111111011111111110111a11001110111111111112222122121112012
1111111101111111011111220121121110010120101210101211211111111111111111111111101111101111111011111110a10111110101111111111101a11101110110111111112222201010112220
1111110111111011100110220202211122011221212222012111011111010111111111010111111011111110011110111010a11111111111111111011101a11111111110111111111012120212121111
0111111011110101111111102012102021220021222212210011111110111010111111111111111011111011110111111111aaaaaaaaaaaaaaaaaaaaa110a11100111111111101111212020011221210
111111101110111111011111221221122101210121102100122220111111111111111110111101111111111111111111111011011111111111111111a101a01101111111111010011221222210112201
111111101110111100101122222202212122021202210022201121111011011111110111101010111101011001111011101110011110111111011111a110a11111111110110111111212211101212221
110111111110011111111112211111112202121120021221221111011111101101011111111111011111111110111110111110011011111111111111a111a10011111111011111111121201222111011
111111011101111111111112221212111102012102200221022000111111111101111111111001111011111101011111101111011110111011111110a011a11011110101100001101001122200111211
011101101111010101011121121111220201021221111111022211111111111100111011111110111111101010011111111000111111011111011111a111a11111011110011110101102211102110212
010111101110111011111121111112211011210202012211120021111111111110011111010001111011111111101110110001111110111111110101a101a11111110111111111111122222111102121
110111111110101111111022010022211021110122020221011211110110111111011110011111111111110111111011111011111110100111011111a111a11110111111011111110202112200222220
011111111011111101110100202222101122120022101122212210111111111111111111111111110111110101111111111111111111101011101100a110a11111011111111111010212111112011121
011110111111011110101021210121122121202200211220220120111101110011111111100010111111110111101111111111111111111111101111a110a11110100111111111012202022111122101
111111010111110110001121121120102211120020111212221121111111101101111101111011110111110111101011101011111111111111111111a110a11111111111111111011110121120222202
101111111111101110111102122222210120021212021221102121011111001001110111111111111111111101111101110111111101111111110101a111a10011110111111111012022222210012202
111111010111111111011122222212110120221201212221011201111111101111111010111011110010111011111111110111111111100101011111a111a11110111111111011111212022111122021
111111111011111111111111011200222112012221112111222220111101001111010111011110011111101111011010111101001101111101101111a111a11111100011101111112112222202121220
111111111011011011111120011220122202102010200102021210001111111101110111101111111111111111110110010101111111011111111011a101a10101101111110011010111111110111111
111111111111111101101112122220111122112121112102020210101011101111111101111111101111011111000011101111110101111101111011a111a11011111110011111111001101111101111
101111111111101111101012212212111021222200101201120111011111110111111101111111111111111111011111111111111111111110111110a101a10111111001111111000100111111101111
101111111111111101000122011222111211022110022100021210110111011111011111111010001011100111011010111011110110111101111111a111a11110100101111111110111110111111011
011011100111111100101121120111221110122010111220201010101110101111010111111111011100111111111111111110111110011111111011a111a10111111111011001110111101101111011
aaaaaaaaaaaaaaaaaaaaaabbabaabaababbbbbaaa1110110002211111111110111101111111111010110001111101111110110101111111101011111a111a11101111111111111111111111101011111
0110202021101122112121212220122221100020a0220212111121111111111110111111111111011111101011101111100011111111111111111111a111a01010111101111110111110111110111100
1110021212221010021200122120122202110111b0111211121211111111111111010111111111111101111111111101111111110101011101111011a111a11111101011111111111111111111101111
1100121121012001111111212222012022201122b1222122122211111001110111111011011011011111011111010111111011110101100111110111a111a11111011011011101111101111101100101
1100112000111011211111221210210122211211a2122112122221101110101111111111111111001111010100111010111111111110111111000111a111a11011111111111111101111011111111111
1011001101011001121001200220122102021221b0111112101211110111111110101111101011111110111111110111110111111111111101122122a112a11111112211222121102111111100011011
1111202121202221120111121221221221011111a0110111111111111111101111110111111101111110111111110111111111101101111111010121a202b11111220122101122100210011101111100
1111122212220122101011001222121211211111a1111101011111101011111110111011111111111010111100110001111110011110001111110222a102b02110202212122111111011111011111011
0100222011220110221210111122022100111111a1110111111011100011100111111111110111111101101111111111111111101111111111111101b110b11111110121222222112211111101111111
1101122121212211112222200222211222100101a0111101111111011101101010111110111111011111111011111111010111111111001111121102b011a11020212111211212022011111111111111
1111111111220020122222221000022122111111a1101111011111100000111111111111111111011111110111011111111110111111111101122222a021a10212021122222212211111111111011101
1100222222121212200212200201200112211110a1110111111101110111110111111111111111011111100101111101111111111100111111121212a111b01112110222201210022211111110011111
0121120222222121222201221012110222111111a0110100100110001111111111111110111101110010110101111111111011111110111111111222a210a00201012102121212222200111111010111
1221002222111012102222112222111022211101a0011011110111110111101111110110111001011111111111111111111111011111110111121201a202b12120120210220122121100110110111101
0211120222222200001020112020012012010011a1111010101111110111111101111111111101011111111110111110111111111111100111022210b022b12112121201212011001001111110101010
2201222102220101212211122200121201001111a1111111111111111111110111111111111111110110111111110101100011111101001011022220b112a10112211201202111112211101111110011
2021201122220220012222022022221112201011a1111111111111110111101111111110111111111011101111111111111111110101011111111222a120b01010110121101012202111011111001111
1101020022220022202202222220111122111111a1101110111011011101111111111111100111101110111111011111100010011111111111122101b220a12112002122110111122101111111101111
2022222222222220122222022102220112111111a1110011111111110111111110111111011110110000111011111111111011101101111111102202a011b00122220112111121210201111111111111
2122222222202222222222222221222121101110a0111110110101011111011111101111111011101110111101111111111101111101110111011211a120a00221022121121211210111101111111101
aabbbabbbbbbbbbbbabbbbbbbbabaabbbbbaaaaaa1111011111011110111010111010111111101111011010111111111111111111011001111100021a211b22222212222212010112211101011111111
bbbbbbbbbbbbbbabbaababbbbbbbbbbbbabaaaaaaaaaaaaaaaaaaaaaaaaaaaaaaaaaaaaaaaaaaaaaaaaaaaaaaaaaaaaaaaaaaaaaaaaaaaaaaaaaaaaba122b10111011212012000100201111101111111
2222202222202002222222222202122121101111111011111111111110111011111111111110111111111110011001011111011111111111111120222211a12121220211202121220111111011101111
2202121022020222220020222212112012210011101111011110111001111001111111101011110011111111111101110101101111110100101021211122a02010001101222120221011111111111110
2222202222022222002222202211111012211101011111111111101011010111111100111101110101111111111111010111111110111111011122212121b21221112110012022021111101111111011
2212022022212022222022022000022110211110111110111110111100111111110111110011110111111011111101011101111110111111010111122212b11012000102112111101111011110111111
2221002002122022222222202220212211011110101101100011011101011011110111111111111111111011111111010111111101111111111102121022a10222201112121001221111011011111111
0110221220222200222220022122210112111110111111111111111111101011011101101111101111111011111111111111001111111111111220121011b21112211222012000002110111111111110
0221202221221021120120212222221221110011111011011111010111110111111100111110111111011001110011110001111011111111111211001222a20210212211212110210001111111101101
2222222122220222020122222212212220001011100111111101111111111011110111111111101111011111111100111110011111110111110121121010b12121212111021120211210111001111111
2002222022002022222200222221122202010010011011111111111111111111111111111110111111111111111111111111110111101110111021010221a10111111220012212111111111111011111
1200222222022210210022200211012222200111010111001111111111110111111110011111101111111111001100110111011111111110111210202212b21012200222102111112111110100111111
2022121222202222221221222102110111011111111111100001010101111110100111111111010101011110111010111111111011111110111112211111b21011012101112012212101101111011111
2220021202022102222121212222110111110101111110111111111110011111111011111101111111110101110111100101111111011111111121121220b11111012221110010222210111110111101
2222222220210102122221022012111101011111011110011011101111011111111011101001011111111110101011110110110101111111011110212112b20222022001120110122211111111111111
2222222222221222222222212112101011111111111111100111111110101111111110101010101110011122212222222111022011211100121222111012a02120211021212111111011010101111111
2222222021202222222222200210011011111111111111010111111100111111111111111111110111111212222102011220202211201021010011111011a11110011101111111101100100100011110
1021221112022122222222122222111111111111111111101101111111111111110100111111101111111012210220200210011222020012212122001011a01100110110111101111011110111111111
1202112122122111202020101210111111111111111111111011111110111110111110111111101111110121011220222121212220220220121201001221a11111111111011111111111111110110111
2021121012021222112212222002111111111110111101111111110111111111110001011111111000110120221122220212211212100220220021212101a10111111111101111111111111011011111
2221222012000210202120211012101101110111011110110111101111110011101111011011110011011120120121022220222121112112022111212121a10111111111011110111011011011110110
0020222112220122122222212122110111111101011011110111111111111111111011011111110011110012121022202222221211212212122222021121a11011111111011111111111101111111111
2212211001121110112212111220110011110111111111111111111111110111011111111111111111110122212122222202210202202221002222212111a11110101111101110111010111110101101
2111121001122210201221202212011011111110110111111111011111111011011111111111111111111112221120221222211022110222222222102121a11111111010111101001101101010111011
1122212221121002221100201202111101111101111111110101101111011101111111011011011011110222111022222222222212222222222211122101a11111111011111110111111111011101110
2100012012212011112211221102001011111111111101111111101111111111001111110101111111101112122122211000222222020122221202102111a11111101111111111110111111111110101
2202011022221120121120022200101111110110111111010110101111111011011111110111111111101111210022222121020021022222222120011121a11111011111011111111111100101110111
1111111111010111111111111110110100110010101111101111110111111111111110111111111111111022111102202210222222002222212212020101a01001010000110011011111011110101111
1101000101111111011011110111111111111011110110111100111111110111010111100101000111111110222122022001221211102022222220100011a11110100111111111101011111111001000
1111001111111110111111111110111001111111011111111111111111111111111111111111101111001021011110201212222200121122222202211221a01111111111011101011111011001101101
1101111110111111111111111111011111011111011111111111100111101011111110011001110110111121222122222202022220210211121202012011a10011111100111111111111011111011101
1111110111111101111111100111011111111111011010100111111011110111111111110110110111010122220020120220120221010121122012121211a10111101111111111111111111111111101
0111110010010111111111101111111111111100111011111111101111011111111001111110111111010222122000202022221022221020002222101220a01111111110111100011111101111111101
1111111111111101010111011111111101111101011101111100101111011101010011111110111101111211120122000222222012221202122020201210aaaaaaaaaaaaaaaaaaaaaaaaaaaaaaaaaaaa
0111111011111111011011111101110111111111111111111110101111110100111111111111111111011222212120222102201021222022222222110111011110110110110111101111111011101111
1111100101110111110111011111111111111101101101111101111111111100111111111111111110111110112102002212222212212220102211211221101111011011111011111011111100011110
1111111111011011111101111011001110011100111111111101111111111111011110011110110101111211112211220212210222222222221212021211011111111111111011011001101011101110
1111111110101111110110111110101011011111110111111111111111110100101110101110100111111112111220222211211022222212222211211211111101111100110111111110111110011111
1111111110111110111111101110011111001101110101111111111111110101111101110111111111110111112212122222202000000221222021120221111111111011011111111111111011111101
1110111011111111111011110110111101110110111110101111111111110111111111100110111111111002112222102222212212210222212021222221010111111111010111111100111111111111
1111111010111111001111111111110011111011111111101111101111110110011111111111010111111212121202222110022102220100201110021221111010111111111110111111100011011111
1111111111101111110101100011111011111111111010110111111111111110111101111111111011110101022220222212112212122211212021212001111110110101111111111110010110111110
1101101111111101111011111111111110111110000110111111111111111111111010101101111111111222011212022201222221222011202121221100111111011110100111111111111011101111
1101101111111010111111101111111011111111111111111111111111111111110111111111111101111202201212222200221010220222222211021101111110010110011111111111111011011110
0110011111011110111011011110111101010011111110101101011110110011111111011111101111101112211202021121022201202121202221211221111000001111011110111100110111111110
1111111100011111111011010100111011111110011111111110111101111111101101101101101101110222110101022221222122212121220111001121100111111111011111011111111111010111
1111111111111111111101111111111111111111101011111000111111011111011111110100111111111101110122222222121121210220201102020021111110111111101110110111101111111110
1100111100111011100101100110010110111111111111111111111010011011100101011111010111111011111112012222121222201212121221111211111011111111101101111111111111111011
1111111111001110011111111111011101111001110111111011111111110110111111111011111101101101111110010001011110110111011111101111111111111011111111111011101100101111
1111111111011110111110111111011111111111aaaaaaaaaaaaaaaaaaaaaaaaaaaaaaaaaaaaaaaaa1101111111001111111111110111111011111111110111011011000110100001111111110111111
1110011110111101111111111111111111100101a110011110111111111111011110110111111111a1110111111111110111111111110111010011011011111111111101111000111011101101111101
1110110111101011001101011101111100001101a111111110111111011111100001111111111101a1111110111110111111110110111110111111101111001111110111111111011111111111111111
1110001011101011010101101111111101111010a111011111100110011111010111101111110110a1111110111101101111111111111111111111111110111110111111111111111110111111011111
0011011110011011011111011111111111110111a011111111011111111111011111110111011010a1010111111101111111001111101101101100010101110110011111111111111111111111111000
0111111111011111111110101110111001110111a111111111111111111101110101101011111111a1111111111111100111001110111011111111111111001101111011111101101101111100111111
0111111011101111111110101011110110101101a111110110100111111111011111101111111111a1001101011111111011111111110111011111001110110111110101111101110110011111111111
1111101110101111110111111001111110101110a100111101111111111111111111111111110111a1100111111110011111111110101110101111111111111111111101111111100011111111111101
0111001100100111111010111101111111010111a111101111101111111001111111111111010111a1010111111111110011111011100111111111110101111011101101111001011111011111101111
1111011111101110011001111111110111111101a111111111111111110101111110111111111101a1111111111011111101111111110011011101101101111111111111011110011111101111101111
1101111111111010101111111011111101111100a101111111100111101111110111111001111111a1001111101111111011111110100010000011111111111111110101111011010101111111111011
1111110111111111111111111011011101110111a111101111111111100111001011111011111111a1101110111111001110110111111111010010111111111110111101111101110111111111111110
1110011011100111111111101101110111111011a111010111111011111110111111001011111101a1110111111111111110111111011110111111111101011111111111111110111111111011111111
1111111110011001111101111000101011111111a111111111001111011011100011101111110110a1100110110111111111111101111111011111010101111011111101111111111110101010011111
1111111111101110111111010111111101111111a111110111011111111011111011111111010111a1011111111111111111111111111111111110111111111111101111111011111111111111111110
1111111011101110110111111110111010111111a111011111101111111011010011110111100111a1110110111100110111000000111111111011101011111101111111011011111111110110110111
1111110110111001111011110111111111111111a111111011011111111111111111101111111110a1011111100111111101110111001111101100111101011001000111101011111111010101011010
0011111101101111011111111111111101111101a110101111111111111111111111111111111111a1111111011111111110101111101111111011011011110111111110111110110110111101111111
1110111001011111001111100111111011111111a011011010111111011101110111111101111111a1110111111111001111111111011111111111111111111110011110011111111111101111001111
1101110100111111111101011011101111001111a111111111001111111111001110110101001111a1110111111111111111110111111110111111011011111111110110111111111010110110111011
aaaaaaaaaaaaaaaaaaaaaaaaaaaaaaaaaaaaaaaaa111001110111111011011011111110111111110a1101101111111101011111101110111111101111110110011111111110111101111011111011111
11111011101111111111111111110111111000111001111010111111110111111100111100011111a1111110010111110111011111111011111111111110011101101111111111001011110111110111
10000011110111111111111110111011100111101011111101110110011111111101101111111011a1111111111110101111110111111110111111111111011010111010111111111111111101101101
11111111010111111001101111101111111111111100011111010100101101110101011111111110a1111111111111011110111011011111111111101110111001111111111110100111111011011111