14 4
147 12
111 44
17 101
61 72
54 77
48 68
152 38
100 78
106 92
1111111011101110110110110101111000111111111111111a1111a01111001110101011111111111111000100111101001110111111111111110111111111111111110111111111111111110011010a
0111111111011111111111111101011011110101110011111a1111a11111011110111111011111010110111111111011111011110111110111101111011011111111101111011110111010101101111a
1111111111110110101011111110111010110111100101111a1101a11010111011111111101111011111011111111110110101111111100111111111010010111111010111110111111001111101111a
1111111111101111111111110111001111111111111110111a0110a01111111101111110110111100111111111101111110011110101111010110111111111111101111101111111111111111011111a
aaaaaaaaaaaaaaaaaaaaaaaaaaaaaaaaaaaaaaaaa11111101a1111a01111111111111111111111110010001011111011111111111011111111110111100111111111010001011101110111111011111a
1111111111111111111111110111101101111111a11111111a0111a01111111111010110001110111110101111010111110110110111110001110010111111011111011111111101010001001110101a
1010111100111011111111111101101110111111a10101110a1111a11011111111110111011111100011111111110110111111101111101111111111011100101111111111110111111111111110001a
1011111111110110111111110111111111111101a11111110a1101a01111111101111001011101110111010011011111111011011011111111111111101111011101111001111101011111011111101a
1111011111111111111011111101111111110101a01111111a1100a01101110111101111111111111110011011011011101111110111111111111101111111111111100001111111100111111110010a
0111101011111101111101111111111111100111a00111111a1010a11010110010111101011110110001111111111111111111011110111110111111111000110101110110111111100111101111111a
1111111110110111111110110000111111111010a11111111a1111a11111111111110111111111100111110101111010011111111101101011110111111111011111111010111101011111111111110a
1110010111100011111111011111110111111111a11111111a1111a11111010110101011111111111111110110101010100111111101110111111111111111111101101111111101111110101110110a
1111001111111110011111011111111111010111a11010111a1101a11111011111101111111011101111111111111001010111111111111011001110111011111110111111111111000101110111111a
1111111011110101111110111111110110101111a01111111a1011a11111111111011111111111111011111111100111111101001111010111011100011011110101011011011110111011111111110a
1111111101100110101110100101111101111111a01111111a1011a01101111111111111111110111111101011110011111110001011111110111110111101111110111111111111111111110111111a
1111111111011111110100111111011101111111a10110111a1111a01111101011111011011101110010110110010111101111111111111011111111111011111111101111101111111111110011110a
1011111100001001110111111111111111111110a11101111a1111a10110011101110111111011111111101110100111111111110101111011001111111110111101111111011111011111111110111a
0011110101111111110111111100110110001011a01111111a1111a11011111011111011111010111111011111111111111111111111101101111011111101010111110111011101111101101111111a
1111111111101111111111111111111111111111a11111101a1111a11111011110111111111001111111111111111111011000000111111111111111011101111111111111011011011101110001111a
1111111100101111111111111010011111111110a11010111a1111a11111100111111111110101111111111110011101111011111111011101011111111101110111101110110110101111111111000a
1111011101110111111111111011001010111111a00110100a1111a1111011001011111011aaaaaaaaaaaaaaaaaaaaaaaaaaaaaaaaaaaaaaaaa01111110110111011111111111101101001101101111a
1111111111111010011111110111100110010110a11011111a1111a1011101110111001111a111111110111110110111101111011011011111a11001111111111111101111011111111011100001101a
1011010111111111110111111110111111111011a10011111a1011a0010111111111111111a111101111010110111011111011111001110111a11101010111111111111111011101111011111111111a
0111110111111111111101111111110111101111a11110011a0110a1000011101110101101a110110111011101110111111111111100111101a10001001111111111011011121212212212022220212b
1011100001111101110111111111111001010111a01110011a1111a1111110011101111111a101011111011110111111111110111101111100a11111111111111111100112212101222022201211210a
0111111111111011111111111111111001110110a01111101a1111a1111111111111110111a111110011101111111110110110001111111111a11100111011101111101112012202222121222110101a
0111111111110111111101111011111111101101a10111111a1011a1111011011111000111a111101111011111011111110111000110101011a01110111101100111111112221021102012012221212a
1111011111111111101110111110110111011011a11110011a1110a0110111011001110111a110111101011101101100010101110110101101a11011010101110101001002210120012101221120021b
1110101111111111101100110110101111111011a11111011a0101a1101010101011111111a111111011011111011011110110011111111111a10111111111011111111111112000202101120210111b
0111101111111111011101001111111111111011a11111111a1111a0111010011111101011a111000010111111011011010012120210012111a01210202212111111010101222021120221111211221b
1111111001111111111110111111111111111011a11111111a1111a1011101100111010111a111110110111011110111022022112020210010b21201110122111111111101121000120202212222102a
1011111101110011110111011111111101011101a11110011a1111a1110111111111111111a111111111111111111110012020212012212102b12020222111211100111111021200110110210102121a
1111111110101111101101111011111110111010a11111011a1011a1111011101101111110a011011110111100111111102002202021021201b01212212201201111011111212202011122111021201a
0101101111111111111011101011111110011111a01110001a1001a1111110111111011111a011111111111111011111120202202002200121b11111112121210111011110022222121212220102122b
1111111111111101100110111111110101111011a11111110a1111a0111111111001111111a111101110101100110111122111221111101122b11211221121211011101111222211121022022121222a
0111110101111011110011110100111110110111a11101111a0011a1110111111110111111a100111011111111110111122010122221100111b22221002121211111111111111112200011120111022a
0111011111101111111011011101100111111111a11110111a1111a1111111000001011011a111111111111111111110221202012121111011b11220212112110000101010212220111211120212221a
1001110111111111011111111111101010111111a11110101a1110a1110110011111111111a111101111111011111101122211111112020221b22212122020211101111110211221201112121212020a
1111111111111101000111111101011010110111a11011101a0111a1111011111011101111a110111011111111000111102012101212112112a20021222122111011111110222210221222111212022b
1111111001110111111101111100101101011100a11111111a1001a1011011111100111111a011001111111111110101022221112001211001a10112221212211101110010112011212221201211211b
1111111111101011111011111111101111111101a11111110a1111a1111111000111111110a110111111111111010111110122221221202012b11111122111111101011111221020211012011122121a
1111111111110101111111101111111101110011a11011111a1111a0111011111110111111a101111110110110011011120211111212122222a01121122112101111111111212212100201212012212a
1101011111111111111101111011111011110101a11111010a1110a1111111011110011111a111101011111011011110012011221122211220b22011212111111101110101010111121100122102111b
1101111011011111001111110111011101111011a01111110a1101a0101010101101101101a111001111110111111110101011100121012012a21110102021211110111111222121221122211111011b
0101111101111111110111111111110111111101a11110111a0111a1111111111101110111a111111111101111111110202012122012021112a01120122111111101011112110121200011111012221b
0111111101111111111111101110111101001110a10111110a1111a1110111111001110111a111111111111110101100212212100122221120b10021102112111011111101122202101012221221011b
0111111111101011111111111111110101011111a11111101a0101a1101101110111101111a111111101110011111111112012001212210221a02222011101111111111100021011211010221110112a
1111011101111010111011111111110101111111a11111111a0110a1010111011111111111a101101111111111111101201011211122110111b12122110220011111101112222110220221212122202a
1111111110111101111111111111111110111001a10011111a0101a1111111110101101111a011111101111011111100201202212012212111b11222220011011101111111222202121221012221222b
1111101101111110111101110111111110111111a11111101a1111a0111011011111111011a111011111110111110111212212002222220121a01111210220211110111112211110112021111221222b
1110111111111111111011111111111111101011a11111010a0111a1111111111111111011a111111111111101111100121211012120211200b22001122101210101111111222212022112212212202a
1110111110110100111110111011101111011001a11111101a1111a1111111111111010101a101111111101111101111200110112221121022a22001121221111111110112101012201120021110221b
1111111110111011111111111101111011111111a11101111a1101a1111111100100111011a111101111111111111111201002022222020021b12112112110111001100102121012122122221222211a
1110011100101001111111110111111011111002b12212001b2102a2001112121111011110a110111100111111111111121122212222200122a21012002202111110101011211010202222121201011b
1111111111111001000111001111111111012210a12110110a0112a0102212221111110111a111011111111111111111222222101120221122b12002102110201111111111111111110110101111110a
1001011101111101111101010111111110211102b12222022b2022b1020122220111110101a101111111111111011111110221021201221210b10202200022211111111111110111010011011010111a
0110110111110101111101111011011112211120a01122202b0221b2222110220110011100a101110100111111111100100222002111221220a01212100201110001111011111111111101111011011a
1111111011111111111111011111111111121100a11012122b2202b2202120220222201210b201111111111011010011112111221121122110b01121221221011111111101011011011011001111101a
1111001111101010111001111101111100122111b12102122b2022b2022101220220121112b221101111011010111111210220221222100202a00200221121111111111110111110111111101111111a
1111111111111111001111111011011110221121a02110102b2221b2212122211112111111b111111111110011110101211101121122200212a10202101110111110111011111111111111111111100a
0111111101110111101011111111111011101201b21121022b2202bbabbbbaababaabbaaaaa011111101011110100111111011111010011110a10111011111111111111101111110111111111001111a
1001111111110101001110110011101101122111b22010222b2222100122012220220212002221110011111101110111111110111111101110a11110111101111111110111110111101111011111101a
0001110011111111101111111111101111102102b10212222b0122222122002022122221220121110110101111111111011011110111111000a11111110111101111110111011101111110101001101a
1111011111011110111101101111010110122221a12022012b2101122221222212222022222120111111111222112112120110220002122111a10100111111111011111111011011011111010011011a
1111011111011111111011011111101110112102b21222111b0222222222222212221202211000010110121210202211110100112121021022b11111011011001111011111110110111100111111111a
1101111111111111011111111111110012201111b12220222b0222200122222020020111212021111110120112121111221101022112111221b21101101111111101111111011111111111010100111a
1111100111101100111101100101111112211101a02022201b2222220022222022122122000211111111121201010211011120112021111100b21111111111111101001111111111111101111111111a
1101110001111000111111011011111101112112b11220221a0021220221220212021211110101100110111111012122122021212000112212b11111111101111101111101111101011011111111011a
1111111111011111101111101101110110211221b22222122b2002022021222020212122011201111111100022222222000222211122112022a21110011111111111111111111111111111111011111a
1111111011101010110111100110111112220211b22202200a2222222122222102222211210221111111012222111021210221111221102122b21101011011011101011111011111011110110111011a
0111101101111111101111111111111011112222b02202222b0012222202200222221112112021111110120212211110002202220102220120a21111111101111111111110111111111101001111111a
1101111111111101101001010101111111221012b02222022b2202222101120021222221222221011101121221111121221222222121222220a21110111111111111110111101101101111011101111a
0111111111011111111111111011110100011200b02202222b2221202222222221012022121211011100122211021121122102111212112010a21111111111111100101111101110111100111101011a
0111101111111110111011001101100101221220b22110212b2222222222222222022211211121111011110120221202122101100122122220b11001111001110111111110111111111111110110011a
0111001111101111110101111111101112111200b01101222b2202222221021222202000200201110111011120111222221122222222111102a01110101111111111111111111011111111011111101a
1010111101111111101111111111111112101022b21212201a2202022022022220221211122111110011010000101222002122102220120022b20111110101110101111000110110110011111111101a
1111110011001111111101111111111111112022a12202120b2021222222022221122201221221011101112021121110012021111120222121a01111110101001101111111101110111101101111111a
1111111010101101111111111111111112212110b22001222a2202222222200122201210122221001111102122111220110222201221012202b01112121100111110100111101111111111110101111a
1111010101110111111111111101111011212222b02221022b1010202022122212222121111001111111102111102020222221221021112102b00122110001110110111011011111011111001111111a
1111111110111111100110011110111102122112a20222212b2202222120202221212221221021111100021112111102220122002221021222b22212201111111111110111111010111110110111111a
1111111110100101111101101111011111121222b22221222b2222021020020220222211121101011110110011222122212022102220220221b02111200111110011111111011111101001111101110a
0111111110011101011101111111011112110212b20222202b2222221222200202222200101110111011112220220212120222222012220221b11212201001110111111111111111111000111101111a
1111111110111111111111111101111112200212b22200212b2221222222222020201201220111111111101222200222222012222212012021b01120111011101110111110111111111111111101111a
1101000110111111111111111110011011121121a22220222b2022222112222222202121211020111010122221012222222222120222122202b22222021111011111100110011111111111111001111a
aaaaaaaaaaaaaaaaaaaaaaaaaaaaaaaaaaaaaaaba10122222a2212222200221222210210211220111110002122202120222220012220221222b12122221111111111110001101101111001101010111a
1111101111111011111111111011111101111110012222222a1122210212221022102220021220111011110101102121212222021202122101b12011111111111101111111111111111111011111101a
1122122221021111122211222102121100111111212100221b2200222222202222222201221121110101121112220010222222102122202102b21110221111110111111111111111101011100111101a
1112221022111221021200022100211101111111122112222a2202022221022022212222102110111110121222222220010201210111220101b22122210111110100111001111111111011111111111a
1011201211112220221210001210112111111112220111012a2212211012112020220001111111101110012110222122222122202222100202b21122210100111111101111001111111111101000111a
1111022211111111121112221121211111111112120112122b1100011112011112101211010111100111101110122222222021101200220100a22212111111110111111101111110111000110101011a
0122211111020221222221212011221221101102022212112b0121110212212111121011101111110101112102022011222122222111212022b22120221111111111111111111111111111011110101a
1122002001122220120201222101212121111112121221210b1222222112121121211111100011110001102211121212002121022020221221b00222110101001110001111111111011101111111010a
1122220221102210212101012000112111111011020121122a1120222222211221202111111111111111111012210012010112122222122012a22222211001111110011010011110111101111111001a
0122201210112021122001111221121111111111111101101a1111101011111111110111111111111110112220220211222222101221221202b20201111011111110111111111011111111011111111a
1122021212011222201110201221011221111111100111111a1111111111010011000111111011011101101101111222012222111021122102b22222111011101000111101111010111111101011111a
1011112212111101122110011111211221111111111101100a1111110110011110111110100111110100111111121222121111121122111020a21011111111111111110101111101111101011111111a
1100220120201021122001121222022121111101111110101a1111111111111010101011101101111111010111100010110221021112121221b22001211111011111110011101111111111101111111a
0112020012121220110102202222221211110111101111010a1110111111111111001111111111010111111110022202210122112202110021b12111021001110111111110111011011011111111111a
1110121011210102211220020011121111110111111111111a1111101101111011101111010111111100111111110221201221002112221212a22022121111101011110111111111111111101110111a
0120111101212111112220011111121021111111111111101a1111110111001010111111111111111111111111121202122212122012021120a11222110101111111111001111111011111101111011a
1122222112122222220100122112021211101111111111111a1111011111101111111111111011111111111011112211101122212101120120b02111101110101101110111111111100111111111101a
1021110002212222222211121120022021011110111011110a1111111011110111010011111011011111101111120122211212211212220122a01112221011111111111011100111101111010111111a
1122012011120121202211111112101201111111111110111a1101011111111111111110101011101111111010120111121122222110022202b02112220111110111110111111110101110011110111a
1101220221022121001221220101022101111110111011110a1111111111111110110101111101111011111001121000221011201112102221a111212011111001100111111110011111110011111011
1022211221122102022201121222012211001111111101011a1011011111111111111111110110101010111111010211212212211011112212a112111211111111011111101101101111111111011011
1111221012111202011121211112212220111011101111111a0111110110111110011111011110110011110111111012102112122111211121b021220210111111111010101101111011111111111111
1112111111121221021222101211102101110111111101101a1010010101111111101111101111111110111110010111010220112021121021a201021111111111011111111111010011011011101111
1122202221122121122210012122210211111111111010111a1011111110011101011100111111111111011100022121021120112121122112b202210011111111111111001011111111111111011111
1010110001022110221110211102021100111011110011111a1111101010111110111111110111110110111111111111111011111111111010a011111111111111111011100111110101110101110111
1112122111211110111101021100220221011110111101111a1011111110001110111111111101011011011111111111110101111110111111a101011111001001000010111011111010100110111111
1112020221221122011221211122111111111101111101111a1110110111111011111111111111111111110111001101111111111111101111a111111111101111100111110111101111011111111111
0121201211212220121201110221121110011111100010111a0111101110110111110011101001001011111011111111111110111111111011a111111111110111110111011111001110111110101110
1122212201112121100220120210222211110111110110101a1101111111111111000111011111101111111111011111101111110111111110a111111111111111111111110111111111011111010101
0111120221101212221112120121202221101011111111111a0011011111111011110111110111101010111111111110101001111110011011a101101111101111011111101101110111111111111001
1100201210011210120111121111121200111101100011101a1101111111101111011111110101110110111111111101001111101111111111a101100111111000101111100101110110111011101111
1111112200211111022221222111101111110111111111111a0111101110111111011111010111010111111111111110111101111111011011a111101101111111100001101111111111101111111111
1112111212101010122110120100211221110111111001111a1101111111111110111111111111111101111111111011111101111111111111a101101111111111111011111111111001111110111111
1111111111111011110111111101011111101111111011111a1010011111101111111111110101111111111111000111111110111011111111a111011111111011111111111111111010111101110010
1101111011001111111101111110111111001010111111111a1111111011111111011011101111111001101110111111111111111111110111a111101101001111111111101111011111111111111101
1011010111011111100111110111110011011111111111100a1100010111111101111111101111010111111110101110111111111011111011a111111111111111111111111111011100011011111111