14 104
142 2
141 118
76 103
6 12
31 54
102 119
25 111
47 51
6 113
2120110212122102212221111111000110111111a011111a1011111111101110111111111111111100010110111111011101111111111111011111011110111111111001111110011111111110111111
2112122111012210021221111101111101110111a111011a1111011011011111110101010011110111101110111111011111011111111111101111111110111101110111111111111111011111101101
2012111021121111112002111111111000110101a110111a1110011011000111101111011010111111011111111111011110111111111011111010111101111111110111101101101111011100011010
2022002222122111101211111111011011011001a111111a1011101100110111111111111011111010111011010111100111011111110011111001111111110101111100111001011111111111101111
2211110011122212021222010010111110110011a110111a1111111111111111111111111100111111101110011111111110111111011011111111101111101101111111110111111100111111001101
1221111112202110121121011110011101101111a111111a1111111011111111101111111111111011111101100111111111111111111111010111110111010011111111111111111111111101111010
2112121010011101211101100111111011111111a101111a1111101100111011011010111111111011111101111100111001111111111111101111111110111111101111111111101011011111110111
2111221202222120221111001101111111011111a100101a0111111101111011110110111111100111001111111111110111011111111101111110111111111111111111111111011101110001111111
0110021201221112200220101011111010110111a111111a1110101111111111111101101011011111011111100111111111111100111111101101111111101111111111110110111111111111101111
1221222202122012222222001111010011111111a011111a1010111111011111111011111110111110111110111101101011111110011111101111001111111111111111111111111100111111111111
2122200200212022212020111101111011011111a111111a1111100111111111111010011101111111111111010111100100111111111110010110111110110111011111111111110011011101110101
1200021120122121210210011111111011011111a111011a1101010111111011111111110101111011111111111111111110111110001111111111111111101111111111111101111111111110111101
1110212110221111011102110100101011101011a111111a1110001111111110111101111101011011111100111101000100011011111111010110101011111111111111111111111111111111111111
2112112221211111110221111101111110111111a111111a1011011111111111111101011110101111001101101111011101101110110111111010101110011111111111111111011111110110011111
0022111111210102211001011111111101111111a011101a1011111011110110110111111011101111011110011111111111111111110110111110111111110111101111111110101111011101110111
2022111220211110012112111111101111111111a111101a0001011111111111111110111101111011111110111011101110111111011011111111111011111011110110101111011011111111111111
2201012122122221012111110011111111111111a111011a1111111010111111011110010100111111101111111010110111111111101011111011111111111101110110111101111111101111101111
1022112110212222221221011111100111011111a110101a1011101110111011111111111111111111010001011111111111111101011000110111001101111111110101111111111111111111111111
2212211111111222011112111100101111111111a111011a1110111011011111111111111111111101110010111111011111110111111110110111111101111101010110010110100110111111100111
1101021101022001111222111110110110111110a011111a110111011010111110111101011001111111111110111010101100101011111111101101111111111011111110aaaaaaaaaaaaaaaaaaaaa1
2102110122221120012202111111101101111111a111011a111100111011111111111111111101101111111101010111110111011111111000111111101100111111111111a1111111111111111110a1
2201111211120122101222001011101111111111a101110a110111110100111111111101111001111010101111111111111011111011110111111111111110101111111111a1111111101111100110a1
2111111200102222121110111111111111111111a101101a101111011111111110111111111111101100111100111100111111111111111111101111111111111111111110a1111111101110111111a1
0221002110202102000002010111111111111111a011110a010111111111010111011010111011111111111111111111011111010111011011111111011111111111100011a1111011111110111111a1
1022211212201221211222111111111111110100a111101a111111100001011111111111011111110010111001111110111111111111101111111110111111111111011111a1111111111010111011a1
2221112102102112022222111100110110111111a011110a111111101110111110111111111011111111111001110101111111011111111111001111111111011101111011a1111101011111111110a1
1201102101110121121222111101111111011111a111110a111111111101101111111111111111011110111111010111111011111101111111101111111111011111111101a1110111101111111001a1
1122211122211222122111011111111111111111a111011a110101111111101110011011011111101110111110111101111111111110111111111011111111111111111111a1111110011011010111a1
1111111111101111111111010101101111101111a111111a101110111111101110010111110111011100111011110111101010010111101101100111101101101101111110a1101101111111011111a1
0111111010111111110101111111101111111101a101111a111111110011110111111111111101110111111111111101111011011110110111110011111111001110111111a1111111011110010011a1
0001110101101110110011111101111111011001a001111a111111111111111111000111111111111111101111111111111010011111101111111111111100111110111101a1110110111111111111a0
0111110111111101010011111000111101101110a111100a111110111110011111101101111111111101100111101100111111111111111010111101111010110111100101a1111110011111111111a1
1011011101101101100110010111111100111011a111011a111111111111011111001101100011101001011111011111011111111100111111111101110101111011111110a1111111011111110111a1
1111111110111110111101010101110111111111a100111a111101011101101100111110111111101011111111111111010110111100111101111101010001011111101111a0111110111111000111a1
0101011011110111101111111011111011101101a111111a111111111111101111101011111111111111101111111111111110001011011110111111110011110110110110a1111100100111111011a1
1111111111111110001111011100111111111111a111111a111111101110110110111111100011111111111111101111111111111111001010111111111111111111011011a1101111011111111110a1
1111111111110111111111111111110122012111b212102a211221011011122111111111111101111110010111111011101111111111111110111110111101111111101100a1111111101111110011a1
0111111101111110001111111101111101201011b222221b022110111210212111111111011111011111111111111011110111111111111011110110111101101001111111a1111101111101111001a0
0110000111101111111111110101111111122211a200122a211121121102102110110011111100111111101110111111111011011111100011111111001011011101011111a1111110010111111101a1
1111101111011111121221112012202121101212a222201a210210110122222101011011111111001111111111110110111111111000111111111011011011111011101111a1111111101111111111a1
1111111111111111212101002122210122212210b222221b121211111212021111111110111101001011111111111111111101110001111101100101111011111101111111a1111111110111111111a1
0101111111111101221201120221212112222122b222222b112111121022112110111011101111011111111011101011111101111011110111101110111111111111110111a1111101110111111101a1
1111110110111111112210221220212222120211b221122a011111112211201111111001101111111111001111110111111111111110111111111111111001101111111111a1111111011110110011a1
1111111111110000201110102111000122022112a222220a121200112021122111111111111010001101001111011111111111111111011111110011100111111011101011a0111111111101010111a1
1011111001101010210221211021012202201212b222120a002121022120111111111001110111011010111100110111110110111111111111111101111111111111100111a0110101111011111111a1
0111111111111101101121222222000111020222b002201b211211112010102111111011101111111110011010101110101010111101101011101111111110111111011101a1110100101111010111a1
0111111111011111211101122012022120022222b202222a111020212222110111111111011001001111101111011111111111111011111111111100111101101111110110a1011011011011101111a1
1011011101111111211211022210202222022202b222222a210221022222021110111111011111111111111111111100100111101111101111111111111011111011011111a1111111111111111111a1
1111111011111110201200102111121211002212b221202b022222211102021111111111101100111111011111111110010110111011010111101111111111101100011111a1111001010111111011a1
0110111011011111222221111111121122222010b102102b112022011211210111111111111111011111111111110111111111111101111110111111111011001111101111a0011111111101111111a1
1011111101111111210021101110121222222210b122210b211001212220102111011011010000100111111111111111111011111100111010101010111111111111111111a1110111001111111101a0
1111111100111100122222221120222102202212b212222b101221222121021111111111110111111111101110100100111111111111010110111111111111110111110111a1111111111011111110a1
0111011111101111021212212201111021102021b212022b111012102122120101010111111111110011011111100011111101111110100011110101111011111111111100a1101011111111111101a0
0110101111101111222200202210111212202220b220221a102101111121221111001101010110011111111111111100001111111111111111101010110011101100111101a1101111011010001110a1
1110110111110111212011021221122122122121b212121a122110111211222011101111111101111111111101001101111111111111110111110111011111111111011001a1111111111110111111a1
1111101111110111211200222221211122220222b002122b021120222122121111101111111110110011101110111111101111110001110101111111111110101111010111a1011110101011111111a1
1110111111111101021011211220212220200002a122222a121212111021121111111111111110111111011111011111011011100111011011111111111011111111111111a1111101111011111111a0
0101110011111011212021102121100220210221b200010a120121210101102010101111111001101011111110111111111011111011011001101111110111110011110101a1110111001111011100a0
1110000101111101222020110102010121111221b222122b102112210111000111110101111111111111111110100110111111111101111111101111111111111101111110a1111110011111111111a1
0111111110111111111122012120022122220022b002220a101012121011021001111111111111101011111101111111110011011111111111011110011100101100100111a1011111111111111011a1
1111111111101111020112222121111120221202b001221a112211211221100111110111111111111111111111111111010111011111111111111111111110111110111111a1111111111101011101a0
1111011011111111200220122222110221121222a020112a120220122211211111101111111011111111111111101101001111111001011110011110111111110110111111a1111111110001101110a1
1111111111111101111112221112212121222202b220211b001112102122222111111010011111111111011111110101101111111011111101111110011101111011111001a1101110011111111011a0
0011111111110011112001122212011202222222b222111a102222121110212011111101111111110111111111111111111111010110101111110111111100011101111111a0101011111111111111a1
1011011111111111221201222212211022002222a100122a210112212121210111111010110110010011110110111101111011110111011011111011111110111110111111a0100111011111110001a0
1111111101111011010120002122102102022022b122122b022112002120112111001100011111111101111100111111110111100101101111011111001011111111111111a1111111111111111111a0
0111101111101111211012202121222212112222a221111b102122202221110111110111111111011010111000110111010111111101011111111111111001101111101110a1111111111101111101a1
1111111111110010210121002120212212222022a222111a101111111111011110110011101010111111111110101010111110101110111111011111111111111111111111a0100111111110110101a1
1111111101011101121211021211221010200111b111210a111111111111110101111111011111111011111111011110111111110111111111111101111101101111111011a1111111111111100111a1
1110111001101111122220112202111100111111a222011a111111100111111111100111011101110111111111111000111110100111110011111110101111110011110111a1101110111110111011a1
1011111111110111111110111111110011101101a111101a110110111101111100011111111111110101110111101001111010111011111011111111111111100111011011a1111111110111110111a1
1111111110101111111111110011011110101111a110000a111101111011111011010100111111101111011100011110110111011111000111101111110111110111101111a1001111010110011111a1
1100111011111011111111101101111011111111a111111a110101011111101011111110111111111111110100111111111111111110101101101011110101111110111110a1101011001001111011a1
1011101111111111110101111111101011101001a111101a111111111111111111101111011110101111111001010111101110111100011101101111111111100111011001a1110111111011111111a1
1110111111111011111101111111111001101011a111101a101011101111111110101111111111110111111111101101111111111111111111110110111111111111111011a0111110111111110111a1
1011111110111100111011101111111001011101a110110a111011010011011011111110111111110011111111111011110111111011011111001011011100111011111110a1111010111011111111a1
1110111111111101111111111111111111111101a111111a011111001111110111111100111111101110111111101111110111111110011010110111111111110111111111a1011110101111111111a1
aaaaaaaaaaaaaaaaaaaaaaaaaaaaaaaaaaaaaaaaa110111a000101111110011110001111111011101110101111101111000101101101111011111110111100101111110101a1011011011111111001a0
11101111011101111101111111111111111111111011111a111111011101111110101111111111011110011110111001111111111101111111110111101011011111111010a1111111001011111111a1
01011111111110111111111111111111110111111111111a100111110101011110111111111111111101111111101011011110110110111110011111111111110111011101a1111101011110111110aa
10111101111011101101111101111111101111111001011a111111111111110111001100111111111111111101001111111111111101110111110110011111101111111111a111111111100111010111
11111011111111111111101111101111101101110110011a101110011110111011110001111011111111001110001111110111001111111111011011111101001010101111a111111000011110111111
01111101001111101111111110100111111110011110011a001111111111111101111010111111111111111011110101111011111111111111111110110101011111111100a111101111001101101110
11010111111111010110111111110011111110111111011a111111110111111111011111000011101111111111101110101111111011111111110111111111111111111110a111011111010111111111
11111111111110101111111110100111111101001111111a011111111111001001000111111111010111001110011101111011111110011111111111111101011111010011a111111011111101101111
11111110100101111111010111111111011111011111111a111111111111111111101100101111101110110011011111101110011111111111110111111110111001110101a101111111111110111111
01011110110100111111111001111111111001111110111a011101111111011111011111111111101100100011011110111111111111111111111011111110111110111111a011111111111110010111
11111011111111011111110011110111101111111110101a011110110110101011110111111111110111111011101111111011111111111111111111110101101011101101a011111111111101111111
11001111111111111111111111111111111111011110101a111110111101110121122211111122111212102221211000000111110111011111111101111110111111011011a111111111011110111111
01011111111111111111001111111110101011101110101a111101010111120102112121212112000122012012121101111111100101110100010111110101011111111011a111110010110101011111
11111111101001111111111111111011110101111101101a111111101111121012112111211222111100121121211111111111111111110111101111111111111111111011a111111111111111111111
11100111011011111001101111111111111011110111111a100011111111112022021212122102001212212002101011111111110111111101011011111110111011111111a101111111010111110111
10101111111011111000100111111101111101011101111a101101110110112211120111221011211101122210201101101111110010111111110111101111101111111011a001110111001010110111
11111111111110111111110110110101111101111111011a111101101100120120111002121200202000122020021011111110111111111111011110111101111111101110a111101111111011111101
11110101111111111111111111011110101101010110110a001111011101102202122211010112222112212012011110011111111111101001111111111100100111111101a111111101001010101111
11111111011111101111011111110101111111100001110a111111111011002122210022220222212201221012220110111111110111111111011111111111111111011001a111111101110100101111
10011111110210112221121212021212011211221011011a111110001111121120122202211111011011111221211111111111110110111111110111111101111111111111a111111101111111111011
11110111111102002112221020202111110212210011111a111011011011122121112021111220122221022112021111111111111111111110001111110010111100111100a111111010111011111110
20121022112210202220122021120211212112202111111a111110111111101110210211111212121011011022101011111010011111100100101111110111110110110110a011111101001101111111
11200212122212001222120121122122100220110111110a111111110111020122021111bbabbbaabbabbababaabaaaaaaaaaaaaaaaaaaaaaaaaaaaaaaaaaaaaaaaaa11111a111111011111111100111
01012112122222122222221111101220121001112101111a000110011111121112100212b02221122121212221010111111001101111011111100111111111111101a01111a110011110111101111011
21122120010222212222212002112221210012121111100a111110111101110112222011b11221212222121112120111111111011111000011111111111111111111a10111a111110111100111111111
21112110010212222211121121211122221221201111011a011110110100122110221120b21122121201112012201111111111100111100110101111100101011110a11111a011111011111100101111
11110211120221200202020220212120121122121011111a111111111111102121202222b02111001122101221111100111111111110101011111111111111122211a10122a221001000222101002111
10121001212112202122000222221212011212022101111a111011010111011111102212a21122212121111020122220012202021112202022121211111011021212b11121a221121122221221111111
02221101122011022211122111211121212221112111101a110011111111122211221021b11222121200211120221111100220212002102211212211111111101100b02012a212221120102011221111
01221122022220111220002212200121210110112101111a111101011011101121212211a01210221022121222020122120122221022111221222011101111120202a11111b210122022200112012011
00211001220220211202210101011012222210221111111a111111111111112211200120b20200012111001202121111022110122002012101212211111111122212b12121a202122120001112122101
12222111211221122122221111122112020121110100111a001100101111122112222211a10102111110202202221211221212111202020021012100011100122221a20201b020221122222012010011
12020112022222212222220221022102201212122111011a111111111111111112112012a21222121120121022221122201100111122201211021201111111201202b12120b121122200110122211101
22210221021222222222201112202211010122122101010a111101110000012112221211a22212121011201010220200021221222210111112212011111111211221a02010b211120211021211112111
12220202012222221222221112122222221010012011010a111111111111121212220220a01220222201112202021221212122221200022112201011111111211122b22122b221102020221111121111
12211122220222002222101121121120211112202011111a111111100111111122010220a21002011112220211221100221020212012112112112111111111122022b10220a122201011100111112110
21111020021222222212012021011220121102221110111a111111110111122210221212b21202012210221220222020222202122222102202221011110111212112a22112a121221121122011221110
01210222112122222212211112111221222121002100011a001011111111120022212112a21222010121201221222000112121221102122222220011110101020100b20012a211222210212000211111
21202110210202201222002101111120021121111011110a011111011111120120101112a02100211211120122222101111111220200012111211201111111111021b22111b002012112212112200111
01221220122222020111122111212212201201212111111a011110001111121020011210a20112201112201122222022200212221110111212011111111111122111a22201b122112222120011112111
12101210112222001222012101220121212112111010101a110011101101122201122121b22111121210212222220200110221111120211222010210111101110120b21120a111022102222111222111
21120122112221201020121120122120112112211110111a011110111111110121111220a11111211111222102221221112210122111202110220010101111212121a10121a222222120202020221111
12002222121022121020220210212211221210121111101a111110111111111111111111a11100101101111101201202201102111222120021122011111111112011a22022a112122221212112122111