12 33
141 118
53 111
70 71
106 81
47 35
152 58
103 25
105 75
26 12
01111010a1111211122a2110220002101111112000111110a111101111111111110111111001111101111111a111110111111111111111111011011111101111011111110011111111111111010a1011
10111101a1121121121a1021201101122120120220101011a110111010111111111111111111101111100010a111111011100110111111111111101111111111111111101111111111111111111a1101
11111110a1101122211b2121021121122211101222111011a111011111111011101111111111111111111101a011011111111011111111100010011111111111010011111110011111110111010a1111
11011111a1110212221b1212120212211221112222110101a111011111111111101111111111010111111111a111111111111111111111111011011110111111111111111111011111111111110a1101
10011111a1102212012a2201120111111002101112110111a111111111111111101111100011101111101111a110111101111111100111111111111101111111001110110110111111011111010a0111
10111111a1100022210b2111021202211211022002111111a111111111111110111111111111111011111111a111111111111111111111001101111110101111111111111111101110100001001a1110
01010110a1122202110b1121222111120221002112011111a111111111111111101111011001011110111011a111111111110011111111111110100111111101111111111111111110101111100a1110
11111111a1121202122b2121211110221001102102100110a011011110111011111111101111111111001111a101111111011110110111111111111110111111111111111111111111111111101a1111
10011111a1100211212b2202212212122022222102101111a111101111111110111111111111110111111111a011100111111111111111111110001010011111111111111111111101011000111a1001
01100101a0021022001b2010202222210022112221101111a001111111110111111111101111111001110010a110110101010011111111111111011011111101001101111111111111111111111a1101
01101111a1112111211a2121112220221021211222111111a101111111111001101110110111011111101110a211111222221211121220212001002111111111101111111111111010101111111a1011
11111101a0100210022a1220100202100011101210101001a111111101101011010101111111110111111111a221122110101121111020211102221111011111111111110111111011111111110a1111
01110111a0112220012b2112102201021011102112110111a111111011111110111101011110100011001111a222121201122201012110120212121001111111111111111101111111001011101a1111
11111100a1122011122b2121011121010022100222101111a001111110001111011011111110111101001101b211112111122102002111110211221101011111001111001001110101101001011a1111
11011111a1110122121a1200221121212122220111111111a101101111101101111111111111111111110110a111222121221011211112212221111110101111011101011111101110101101110a1101
10111110a1120210110b1220222021012222201221010111a111111110010111111111111011111111011001a211222011221110210102222211110001010011100111111111111101011111111a1111
11011101a1111022211b2022201110021011011222111111a101101011111011111011111110101111110110b122022222201211011111210110100111111011011111111111111111111011011a1111
11011010a1112212121a2122222100222222221212011101a111111111111111011111111110011110011100a122221121221101222222211122122111111011111101111111111011101011111a0111
11111011a1101011211b2121202211001120221211111111a111110111110011111111111111111110111111a020122220102111210220010212221111111111000000111011101111011011111a0110
01110111a1111112110a1022111120221212222211110111a111110111110110101111101111111111111111a111202221011020012111221001111011111100111111111011100111111111110a1110
11111111a1021021122b1212022121211201120021120221aabbbbabbabaaabaaaaaa1111111101111111111b112121121211122021200121201210111110111111111010111101111101110011a1111
01111110a1120112112b022121112111221211221111211222102111121221110111a1101111011111101111b211221010121212202212012211212011000111011111011001101111111111111a1111
11101111a1020221121a022221121000222122202101120210111022211122001111a1111111111111101101b221222212112111112212221222221010111110111111111111101000101101011a1111
01100111a1111222112b002101210121220122020222102121212122021112211110a1110111111110000110b221222221121122121121111001100111101101111111010111011111011011101a1111
11111111a1112211122b210021212022222222201201102012211002202211001101a1111111111001111111a220011221122101021212212222112011001111111111111011111111011111111a1110
11110011a0111112011a111111111111221222222222122222221211110112111101a0111011110101101101b211220111111011100010011212212111111110011111111111100110001111111a1100
11111111a1112221111b211220222220120122221101111200212222021002010111a1111111111000001111a021012202212222211021011221112111010110111110111101111111111111111a1001
11111101a1121222021a221211021211220222222212112212220220011112210111a1101000111110111111a222211001212211111011110222202101111110011111110011101101101110110a0011
11011111a1011111011a111111111100122120201121201222000221101212201110a0011111111111011111a222200112220111111221110201211010101110111111001111111111111111001a1111
00100111a1111111110a011111111111121220212222122121111011002021211011a0111111111111100110a121122112121212022221211222211101011011111111111111011111100111101a1111
11111111a0111111110a011111111000011111022002100211201120122121100111a1111101101111011110a211221200022120122222112210121111111111101111010011101111111110011a0111
01111111a0111111111a011111110110202101112112112002112121212121111101a0111011111111111100b221121212212110221101210222021010111111001011111011101011101110111a0110
11111111a1111111111a011111110111112101010222022112111222222110211101a1011111111111110111a212211020120112112121211122021001010001111111111111111100011111110a1111
11110111a1111001010a111101111111011121020111221212021011121120211111a1111101110110111111b211111122221121211211112112222111111101111111100111100011111110110a1111
11111111a0111101110a111101111101110111022011121022211012110020001110a1111011111101111101a101211001122112121112111210201111111100111111101111111111111101111a1110
11011101a1111111101a111111001111112101202101121021202210112110110100a1111110111110010111a212112221210211122212201222202101111110101001011011100011111111011a1011
11111111a1010101111a011111111010122202212122022222212122222111111111a1111011101111100111a121211222202222120222222111121111110111110001101101011111011100110a0111
11010110a1101010111a011110111110121212121101222202112221111221111110a0111111111101111110a121120222220210021010122121212111011110111111111111111111110111110a1011
01110100a1111111101a111001111101122122201212012111120212122122011100a1110110111101011110a111120112112222102101122110111111101110101111011111011111101101011a1100
11110101a1111101101a111011101111112000112110221211100201122012111101a1111011111111111111a222111212222120101111122212022111100111111110111111101011111111111a1101
11111101a1010101011a110111011010221221220021212101121112012211011111a1110111111011011111b211001abbbbabbabbbbaabababbbabaaaaaaaaaaaaaaaaaaaaaaaaaaaaaaaaaaaaa1111
11110001a1101101101a111111111111200211211012101110111122000112210111a1111110111010111111a011111a0110111111111111111111111001101111101111111111111111110111011111
11111111a1101111111a101001101111020122022120111011021122211210111111a1100111011101111110a111011a1111111101111111111111111101011111111010101001011110110110110111
11111111a0101111111a111101110100110100222210102221121202122211211011a0111011111111111110a111110a1111111111011111101101111110111111011110120211100010112200210011
01001111a0001110110a101100111100121012022211210122112121201112211111a1101110111111010111a101100a1111011011111111111111111111011111110111111221210211011200222220
11111011a1101111111a111101111111222221120122202002210202222211111111a0011011001111101000a011110a0111111111100111110111111111111111011001121020222222011211101210
01111111a0111011101a111010011111021112222201111001102222010221111111a1111111101110011111a111111a1101111011101101111001111101101111111111122122111012220212212121
11111111a1111111011a110111111011212211100110011221201212211212211010a0111011111111101111a111101a0001011111111101111111110011111111111101021012222221120122010200
11111011a1111110111a011011110011022112212122211021111111112200111111a0111011101110111011a111011a1111111111001011111111111111110101111100111210211112212222220022
11011011a1011111111a011111111011221102222222221101211121022112111111a1001111111111101111a111111a1101011011111111011011011110010111111011122102022222210012122222
10111011a1111111111a110100111111102110201122112121111212110001101111a1111111111101110101a111011a0011011111111110011111111110111100011111122222221102102122221011
11010111a0110111101a110110011110111111111100111110011111011111111010a1111110101111111110a111111a0101111111110111111101110111101000111111111010210011111121221211
01011111a1111101111a101111011101111111111111111111111110011101111111a1111111101111111100a110111a1110111111111111011111111101110111111011100112211221022201101102
11111111a0101111100a111111101111101101111111011111011011011101111101a1011111110101011101a111111a1110101111001111111110111110111011110111112101122121221222121210
11111111a0110110101a111111011110011010111011111011100110110011110101a1111111111111111111a101110a0111110111111111111101001111111111010011101122222202211210121111
01001100a1001111101a011111111111111101111010111111101111001111100001a0110111101101111011a111111a1111110111111100111101111110111001111101120212211112102222121112
11111011a1110111011a111111010011111011111111111101110010120222122202a0201121100221201211a111111a1111111111111111111011011111111111101111112122220221110011022100
11110110a1111111111a111101101111111110111011111111001111012121011111b1212202210122122211a101011a1111111101110111101110111101111011101111111221122120112211212101
11111111a1001011101a111111111110011111111011000011011110010221112022a2212221210222022111a101101a1100101101111111111110011111111101001111102111202120221101102212
11111110a1111011111a111110110101010110110111111111111111121022102210b0221211020012112011a111011a1111101111111111111101111111111111111011122022022212102211112010
11110111a1100011101a111111111111011111100111110111101012122011101212b0111211221212102211a111211b0210222210121102212221020111111111111111111101212212121222222202
10011110a1011111111a110111111111110111100110111101111112100211120011b2211211200222102211a111221b1102122111112012220202210111111100010111100112021210212200211211
11111101a1110111101a111111111111111111111011101110111112102222122211a0201100012122201111a012212b1201202001112221101012212101001111101111121012110100200121021111
11111111a0111111111a011111111101111111111110111100011112102120102200b1012211202111121211a010122a1011201200212112020012100001111101011111101110122121021021111121
11010110a0101101111a001111111001011110110111101010011100222101201122b2112211212212212111a110222a1221022011121011101211111011111011110011111112201222211111121111
11010011a1100111001a111100111101110110111111111111111112212022212100a1211110200021222210a011101a1212020221120220111111112111101111011111112221211120121222222222
10101111a1111011011a111111111011111110100111111011110110210220102212b1211002202201221211a112222b1021222221212021220222200210111111111111122111212111002122122222
11011111a0101110110a111111111111111111111111111011111100221211100102a1211110101222221111a122102b1222202222221221222002102011110111011110121221112022112221100221
10100110a1111100111a111111101011111111110101111110101111021212022221b0201220111210122211a111022a0222020211112111222222210010111100111110121222202121202022211201
11010101a1110111011a101101111111101101111111111011001110220111011220b0122010221112012111a121201b1022222222011022222200112111101111111110101221202120201121120021
11111110a1011111110a100011110111100111111111101101110012221120111101a2110201220121221111a122220b2012202202221022102212210111101111111110122202201121122110201221
01101111a1110110111a111111001110111011111101011111111112121012111112b1221111110212122111a121220b1111122201222122200202120201111110111111102012112101202211112101
10101111a0111111111a111101011101011011111111110111011111202222111110a2222112221022121000a001000b1222112202222012222002102011111111110111020101110112202220211010
10111011a1011010111a111111011111111110111011111111111101201112212121a1220012120010120111a122021b1121021112122221002202222011111111111111112221100021121102202021
01111101a1010101011a110111101111110110111011111011111111111110122011b1220211111121212111a112202b1212222222212222211002221111111111111010111011111111111110101111
11111110a1111001111a111111111101011111110111111111110012111122112120a1221102101212202111a122202a2222011021222212221122212201011111111111111111010110100111011001
11100010a0111101100a101111111111011111011111111110011112112211122121b2110222111002011101a111112b1212002012220222121222222210101111111111111111111111111101111101
00101011a1111011111a101110101111101111110111101110111102011210212201b0020202212221212111a111122b2022120022100220020221020211111011101110110011111111111010110111
10011111a0111110101a111111011111111110101111110010111111211201212020b1112011221011002211a112220b2222222212221112120222222210010101100110111111001111110111111011
11010110a1011110111a011111110101111011011110110011011112102111220012b2220110211021220011a122020a2222221121120221222221202211101011101111110111111111111111101011
11111101a0110110111a111110101111101001110111101111101112222012100112aaabbabaabbbbaaaabaaa110022a2220122220102220220220222011111010101100101111111111111111110110
11111111a1110011111a111011111110111111111100111111111112010110211211002222011211222201101112212b2120102202201100202212120211001111010101011111111010111101110111
01110110a1111110101a111111111111011111001111111111111110121010210212200221120211202212110101202a2222112212202022220102022011111111111001110111111111111111101010
01111011a0111111111a111111011111110101111110101011111112012021102011201212202112210202111101222b2221201102222021121200122111110000101111111111110110111111101111
01110001a1111111111a011011111111110111101101110001101112110102220221111222221220100021111110121b2222000222220222212201120010110111110111011111110111101111111101
11111000a1111001010a111111101110111001110111111111111112212222021102111222222211221010111110222b2202202020222220222022022201111111101101011110111011110111111011
11111111a1011011110a111110111101111111111111111101111011002021111112221222202201122202111022212b2220122022221220010022222211010111101111100111110110111111111101
11110101a1111111101a111111110011111111110111111101101111110110110011111010011010111011111122220a0222220102221222212122222011111101100011101111100011101111111011
10111001a1101111111a111100101111110011111110010011101111011111111111100110111101111111011112112b2222020021221220022211221011101111101011011011110110110110110011
01001011a0011111111a101111011111111111110111111101110111111111111101111101110111100101101122020b2221222222122100222220202211111010111111111111001110111111111111
11001111a1101111111a111111101111111111101111111111010111111111101111111111110111001011011122220b2222022120202100212212010111111100110111011110111101101110111111
11111100a1111101111a111111011110101011101110111011111110111111001100111110111111111100111112100a0110211112220110101221221211011011111111101110111111111100111111
11111111a1111111111a110110101101111111011111111111111110111010101111110011111010110011111112000b2201222110212101112101222211110111011011011111111011111111010111
10101101a1110100111a111110111111111111111111000111111001111011111111111111111101110110011111122b1122120101220112210122112011111111111011001110110011111111111111
11101100a1111111111a111011101101110111111101111111111110101111100111111011111110011111111112121b0111122221221022111001000211110111101110111111101111111111011011
11101110a1111111111a111111111011111011001111001111101110110111111110111110101111111110111102210b2011111111222000101111111011101111111110010101111111111011111111
11111111a1111011010a111111111110001011111022110010222021002121112212110111111110011111110112222b1121222110221122211222122100111111111111101111011111111110011111
01111110a1101100110a111111111111111011211212120220222111202220122121110101110110001011101111100a1100111011011111110111111011110111110110111111111111111001010111
11101111a1010111011a111111111101001011200202202112212120200121101112110111111111101111011110111a1111111101101111110101110111011011111111111011111101110111111101
11011011a1111111111a000111111111100111220021222212121102211101010120211111111111101111111110101a1110110111111111110111111111001111111110011110011111111111101111
11101111a1111111111a011101010111111111112110221122221121212011201021111111111101010111011111101a0101111111101111111111011101001111101011110111111111111111111111
10011111a1111111011a010111110111011101012122221021110112121001222222210101101011010111111110111a1111111111110101110010111111111110110110111001100111101111101111
10100111a1101111111a011011111111111111122210212211111221101121021110210111111111011111001101011a1111110101011111111011111111111111111101011001111111111101010111
10011101a1111110101a101111111111111111222221102211021122200121121201111111110110111101010101111a1111111101111101010100111101111111110001010101111111011001111111
11111011a1100011111a011111110110111111100221102001212111211002201120010100011111111100110111101a1111011111101111101111101110101110011010111111111110111101111111
11110111a1101101000a111111111111010111021202112120021210121212210212201111111111111101111111000a1111111101101110011111101111111011001111110011111101111101111110
10111011a1010111111a111110111011101111221011121212112122221110211200011111110111111011110110111a1101111111011111111011111111111001110001111010100101111101101111
11111110a1110101111a110101111101111111122112001122021212222022020021211111111011010111011111011a1001111111111111011011111111111110111111111101111111110110111111
11111111a1011110111a111111111111010110020101110122120102121210122211011110111111111110111110111a1111001111110111110111111110011101111111011111110010101110111111
11101111a0111111111a101101010111011101102212120101221101222102112002211111110111111101111111000a0111111011011111111111100101011010011111010111111111111111111111
11111111a1110011010a111111000010111101010101212212100101111222201102200011111111111111111111110a1011111111011110011110111101111110100111011110111001001111111111
01110111a1111110101a101111111111111111112202112011112211022211102120211111101101101111111111111a1111111111111111111110111101111111111100111001111011100111110111
11001111a1011111111a111101111111110111122222012220010201020200101112101001011100110111010101111a1111110010101011111101011111111100111101111110011110111111011111
01010111a1111011111a111110111111011111210202112222220022122212120012011110111111110111111111010a1111011111011011111011100111111111100111111111111111100110011011
11110011a0111001111a110111011111111111210112112220212022111201222220211010111111111110111111111a1101111101101111011101111111111001110111110101100111010111101101
10011110a1111111111a110111111100111111222121112222122210122121212222211111111111110101111111111a1110011111111101111101111111110111001111101101111011111111001111
11111000a0111111100a101101010111011011112121212002221122202102111011101111011111111111100110111a1101101111011110111111111110011110111111100101110111111010111111
11001111a1011010101a111111011111110011212220002112012121200212021111111111011111111111111111111a0111101110111111111100100001010111111101110111110111111111100111
11101111a1110110110a011101110101011111211011022111022221121100010221201011111110111010111010111a1111111111111111111111111111111111100111111111110001111111111111
11111101a1100111110a111111111011111101121202100010222200212200212122011111101011111111111001111a1111111110101111101111111101111111111111110111111110111111111101