90 104
6 13
96 110
23 61
127 48
34 62
86 78
139 64
13 61
150 92
1011111111101a1001110a1110111101111011101111111111111011111111111110110a111111111111001111111110111a111111110101111111111110110111111100010101111111101110111111
1111111111111a1011111a1110111111101111011111111111101111111110011000111a101111110100111010111111101a101111011110110111111111110101111111111111001110100111110101
0111011111111a1101110a1011011110000100111111111111111110111011101101111a111111111111101110111101101a111111101011011100111111111111110111101111111101111111111110
1010111010011a0111111a1011011111111001011111111110110110111011111011111a101111101011111000111011011a101111010101111111111111111111110100101101111110101111111111
1011111111111a0101111a1111110110101111111111111111111110101111111101111a111011001111110111111111111a101111111111101111110111111111111101111111111111100111111111
0101111110100a1111100a1010011101011110011111011111110110001011111011111a111111101111111111111111111a111111111111011101101111111111111111100111011111111011110111
0001111000011a1111101a1110111110111110111011011111110111011111110111110a111111111111111111101110100a110111111011110110111010111111111011111111100100101110011111
1110111011111a1110010a0000111111011111111110111110111110111111111111111a011101000111101111111101111a110011111111001011111111111011101110111111111011110011110111
1110111011111a1101111a1110101111111011111111101111111111110110111111011a101111101111111010100101001a111100111111011111111111111101111111101aaaaaaaaaaaaaaaaaaaaa
1111101111100a1011111a0111100111111011111111101111111111011111100100110a111011111011110111001110101a111001111110110111111010111111101001111a1111111101111111111a
1101011111011a1111111a1111111111111111011111110010110111000111111110111a111011011111101011111001111a110001111010111111111111011111110110111a1111111101111101111a
1111100111111a1011111a1111001111110111111101111011110111101101010011011a110110111111111011111110111a111111111111111111110101101111111101001a1111101111111111111a
1111111111101a1111111a1110111111111111111111011111010110110111111111110a011111111101111111011000111a111111111110111011111111111110111111110a1111111111111101111a
1101111101010a1110101a1111011111111111011111111111111111111111110111100a101011110010111111111111111a110111011110101101111011111111011111111a1101111111111111111a
0110111111111a1111110a1111111110110011111110011111111111110111110111101a101111101011111111111010111a011111111111111111111111111111111011000a1111110111011111101a
0101001011101a1101111a0010010111110010111110111101111101011111101101111a110011111101011101110111111a111111101111101110110110111011110010111a1111011011111111111a
1111110100111a1111101a0011111111111111111111111111111111111010011111111a111111101010011111011111100a001011111011111110111111111011110111111a1111110111011111001a
1010011100100a0111111a0110111111101011011111111111001110111111111001101a111111011010101111111101111a110111010110111111111111111111001101111a1111011110111101010a
1110111111111a1110001a1111111111011011111111111010111111101101111111111a111111111111101000101011111a011101110111110110110111111111111111101a0011111011110111111a
1101101111100a1011010a1011110111101111011101111100111110111111001111111a101011111110111110011110111a111111111111000111101110111011011111110a1110111101111011101a
1111111111111a1111011a1101111111100111011111011010111111111110111100111a111001111101011101011101111a111101100101110111111111111101111111111a1011111011110111111a
0111111101111a0111111a1111111111010101110011111110111111111111111111111a111101111110111111101111111a111111111101110111111110111111111111100a0111001011110111101a
1111001111111a1111110a1111101111110111101110110111111111111111110111110a111111101111111111101111111a111011101111011111111101111111111111001a0011111111111110011a
1111111011111a1001101a1111111110111111111110111010101001011110110111111a111111101011111111111111111a110110011011111111110110111111111101101a1110111110011001110a
1111110111111a1111110a1111111111111101101010111111111111110111111011011a110011111111101111101111111a011111101111111011011111111111001111101a1110111100111111111a
1101111111111a0101111a1111101111011111111111111011111011111111011111011a110101110110111111011101110a110111111111111111111111101011111011110a1011100111110111111a
0101111111110a1111111a1111111111010110111001111111111110111110111111011a111111111111111011111110111a111111111111000110111101101111101111011a1011111011101111111a
1111110111011a1111111a1111110111111110111011101101100111011111111101010a111100111111111011111001111a111100111011111111111110001111111101111a1110101010101111110a
1010111111111a1111111a1101111110111100111111111111011111111101111111111a110111111111111111111111101aaaaaaaaaaaaaaaaaaaaaaaaaaaaaaaaaaaaaaaaa1111110011111110011a
1110111111011a1111111a0011011111111110101001111011111011111111011110111a111111111111110111101110111101011101100111110010110011101010111011111110111110111110101a
0111011100111a1111111a1100101111111111110100111101111011011101011011110a101111110010111111111110111100011111111110011111111111111011101110110011011111111111101a
1111111111111a1101111a0111111111111110001111110100111111101111111111011a111111110011111111111110110011111111111111111010111111010111101011111011111110001111111a
1111111110011a1111111a1111111011101111111100100111011101101111111111111a111110011101111011111110111011100111011110111111111111110111110101101101111011110111111a
1101101110111a1111101a1111101111011101101101011101111111111111111110111a111111100001011011111111101111111110011111111210211122202121221212112201010111110011011a
0111110101111a1110111a1101111101101111111111110110110101011111110111111a111101100110110110111001011111111111111021012011102120112111122210022201111111111111010a
1011011111111a0111111a0111111101111111101111010101101110111011111011101a110101111111111110111110111111101111010122121111121122102202222221100221111110110111111a
1111110011111a0011101a1011111111111101111111111111111011111110111101010a110111110101110111101111111111100111111121101110221222121202110221212121111110111110111a
0111101110111a1101111a1011110110001101101011111111011011110110111101111a110011111111111111110101110111111100111102121220101122201012111221021111110110111111011a
0011101000111a1111111a0101010111011111110011111111011111100000110010111a101111110111111011110111101111001010111120002101020110200210211221221011111110101111110a
0011110111110a1011000a1111111111101101111010111111101111111011001111111a111111111111101111111011101101111111111121012222221220110121111102022101111111101111111a
1110111111111a1011111a1110101011111111011111010111111111111110011111101aaaaaaaaaaaaaaaaaaaaa1111111011110111110010222122212202212221122220102110111110010011111a
1011011011110a0111011a111001111111111111011111111111111101011011001111111101111111011011011a1111101111111101111121221211012022121212022220021011100011101011011a
1110111111111a1111111a010110111111011011111111111111110111010110011111111011010111110111111a1111110110111111110112012011112111121202120220000001111100101001011a
1001110011101a1111011a111111100111111111011011110111111111111110111101001110101111111101111a1111111011110101111112021112012012012012101211220021111011110011111a
1111101111011a1111111a111011111111111010101001111110110111101111111111111111111111011111111a0001101111101110111111220211012210211211201022120120111111011011010a
1111111101011a1111111a101111110100000111111111111111110111111011111110011011111110010110110a1111111111101111110112110200112200111211012110121221110101001111011a
1121110212112a2201020b220100012112022110110111111110111111011111111111111111010011111110111a1100101110111111010110122222110022211210111221102211111111111100111a
2101122121021b2212221b220022222022121221101222102010101111111011110111111111101101111111111a1111001011111101111120110111001111202221120211222111010100111111111a
2021012220100b2022022a222222212200002221212222220101110111111110111011111111000011111011111a1111101010110110111022112201012110200221110222111101101101101111011a
1111121122202b1002001b000202202012220020110220120001111111010111111111111101111111111111111a11111111111011101101222122022211202222012222222202212221102221111111
0011000220222b1021220a122101200222022020221111202101011111110011111111111101101101011111010a11111110100111111110102221120101222211022122121121222122011201011111
0112221220212a0212220b222202202212122021022001122110101111110111111110111101111111111111011a11110011110111111111202021021011221120011222220021211012200122101111
1112222112222b1021022b020212122222222220222102222211110111111111110111001110111111110110110a11101111111111111111021122120022222202121022122220012221011022000110
0001122102221b2210222b222012222221210212220210221011110011011111111111111111011111110111101a11110111111101111111221200201210202220202120021202212121210111111111
1211122221122b0020020b022222201002201221000200210211110101101111011010100111011011111111111a11111111011111110101002111211122220121110222102222212221020210111111
1221220222021b2222221b202222222112020211011020211111111110111111111110111011111101101111111a01111111111011111011101120220122220020222222210122211012102112000111
2120222122121a1022022b222022102220122222212122022111100101111011010111111111111111111101111a11111011101111011111111111111121222222222022022222210020121220111111
2020201102220b2021022b222202200222222111101200222201110111101111010111101010111101011111111a11111111111011111111011212202011022222222022121121102012101221111111
2220112022020b2222222b222202010222012220002100221010011100111101111101111111111001011111111a11000111111111111111211221111112022222022212122122222222210122211111
1122111022112b2200222b220220022201222221222010011011111001110011110111111111011111010110011a01011111111111111011112121121222120211022210211211112202220111110111
1122212220211b2220222b222122222202222210221121221011111011011111111011111111111111010110101aaaaaaaaaaaaaaaaaaaaaaaabbbabbababbababbb2221120221211111210122011101
1211211120011a1121102b2022222211201221011022121011100111110011001111111111111111110100111111011111101011111111101122221221011222112b1202102212022212201121101111
2210002012010b2121222b2212122220201022210212221112011111101011001111111011111111111001111111110101101111111111112221122020210022122b1211111122020220112012111111
1212211122221b0212122b2200022212222220200121122111111111001111111101011101220111212111210021222200112011101011112220000212121212220b2100120122111212111210010111
1221210222022b2221222b0222222022121122201112121212101111111011101111111221122112012121212011110212122211110110111111111101112212221b1111111210112222002101211111
2220221222102a2221022b2222200220220220212210201202001011110111000111111102222221222102012211102122002211111000110011111100011202012a1200022021222002212122111101
2012021110222b2120002b0222222012222221022022221100111011000111111110111210110210021211022002221211012011111111011111110111111002121b2122211222211222221111210110
2110112122102a2222202b2202122102220210211222211021111111111011111111111211110201010112211012121011122111111111111111110111101121112a0221111121011220200202211110
1210111212222b0122121b2022222022222112022111020221110111111011011100111210121110121101220110201120121011011101110001111111112112111b2002102011000211211022011110
1221222121020b0222222b2221022122202022012011111202111111111111110110111101021011010121121221111122221101100111111010111010000011022a1121210112010200221212111110
0122121022212b2222122b2222222020001002202022112202101111010111111011110210110121121221220122020012201011110111111101001111110102002a1110221111121111212221211110
2221220202202b2021020b2002002022122110211120221221110111111111110111011122021200100022221212122121212201110111101111101111112212222b2221112122112212111022111000
2110201211221b0011002b2221220221121221011221211220101111111111010111101121101221122012222010121222001211111110101111101101112212101a1002021211212221111221011111
2201121122222b2002222b2122222222221221101112122112011111111110110101111101211112210222001220111102211111101100111110111111111120022b2221211201202202010120111011
2220111221201a2222222b2022021122020121112112210001101101111111111010100222201212102122221121120121110101110011111111101111112020121a2222212111210212222112011111
2202222222221b1222212a2222022222002112202021212121011111111111111111110212221110120221000110110210120211111110101111111111112122222a2122222121021020212211210110
2121202200221a2222222b2220222222222120001211112100011111101111111001111212121112122121121121212111222101111111111101011111102121112b1210212020110212012111110110
1011111010111a1110112a1221212122101220201201022112111110111000111010111112120021222022210121211102221211111111111111111111100201111b0020221222222100222200222210
1101010111011a1111111a1001111010111111101111111110111111111101111011011212211221220121102120011211011211111011011111111101111221210a2100012221222201212220121020
1111100011111a0111101a1111111111001101111111110011011110110111111111110110002122122120121211212011121001111110101111101111111122121a1111202112222221220222012222
1011111111110a1111111a1111111101011101111111110111110110111101111111111220222202202202211101021122200011101011011111111011111110110a1001011200121121121012212111
1100010111111a1111111a1110110001111111101111011110110111111111111110111111121120122010221101222112122111111011110111101111111111111a1111100020120100202101021020
1111111110111a1111111a0111110111111111010111101111001111111111110110100100021102012101022210101101122201011111101111111101011111111a1112222110222112012112222000
1110101111011a1011101a1110111111101010010111111111111101101010110101111012112121010221121101000110222211110100001111110111111111101a0112210111101211222121012221
1111110101111a1111111a1011010111111111001111111111111111111111011110100001012211012112022200221221102001111011111011111101111011110a1102112020211121112000221220
1111110110011a1101111a1111111111110111101011111111101111111111001111111220022211211011222121212110112011110101111111111111110110111a1111110210210200000120210021
1111011111111a1111111a1111111111000111101111101101111111011111111001111022101012112112202121112210222011110111011111110111010111101a0102210120102201202110112010
0111111011111a1011011a0111001110101011111111101111110111111011001110111121211121012102221211202112110110111110101110101011111011111a0012001020110122122112212222
1111111111111a1101110a1110011111011111111111100111110111110011011110111211021110102222212111102210202211011110111101001100011011111a0111202112110112011021110222
1011111011110a1101011a1111110111111110111111011110111001100111111111011221100210101121012200200212221211111001111101011111111111111a1112221220112101122121221221
1111111110111a1111101a1011110011111111111111111111100111110010111011101122212211221122112111111120222011111011110101111111111100111a0110111121121011102222221212
1010111010111a1111111a1110011101101110101001101111101100011101011111110120112122100201222211112012122111111110101111111111011101111a1111120112110111220010102120
1111111111111a1110010a1101110111110001011111110110110111001010111111111222222010202212120202121012011111011101111111111111111111011a1112112110211022111222212222
0011101111101a1110111a1101111111111111111111111101111011111101111111101211022010221221122021112112111211101111101111111111111010111a1011210102022110221011211211
0101111101111a1111111a0111110111111011111111111101110111111011111111110111101111000110111111111111110100011110111101011011101111111a1111112222212220111121111210
1100111111111a1110101a1011011111101110111110100100111101111101111111111111111011021020012212201120011211101221101111110111111101111a1101112121121211220021011010
1110111101011a1011111a1111110111110101111011011011111111101000111111111111111110110011210221222010111200121002120111111101011111110a1010220221102112111021201120
0111011110011a1111110a1010111010011111111111011101101110110111011111111111110111101122122112212222200112022100121111101111111101111a1100021222021122211121212210
1101110111110a1111011a1101111011111010111111111110001110111011011111101101111111100121220222121111010101022201201110111111100011111a1112112210112110221100112212
1101111111010a1111111a1011101111111111111111111010001110111111111111011101110111112212210010201221020222211211221101111111101010111a1110022102221220110000112120
0110100111111a1111111a1111110111111111111111111111110101011101111111101110111100121011211120211111012102112021021111101111010111011aaaabbaaaabbbabbabbbbabaaabaa
1100011111101a0111110a110011110111101001101110110101101111011111110110111111111112112112021022121111221120122122111110101111111111111112211021110211111021112212
1111110111011a1111011a011111101111111111111111111111101111101101111101111111011111110202100221012111122221221221111111111111111111111111120221122122100211100121
0111110101111a1111100a111111101100111111111111111111110111110111101101111111111112121111222101111102112210220221110110100001111111110110211110021011221222100212
1011101011110a1011111a011110110100001101001011010111110111110111011110100101011111212122122101222012121122212110001111111111111110111111112210121101212000011111
1111110111111a1101110a110101111101111111001110110111111101100011110111110111001112212222112101212201102121121102111011011111111111011112201012101222012220212102
1111011111111a0101111a111110111101110011101111111111011011111110111111001111111100221211221120112122102222112221111111111010101111111112221212112212222212222120
1111110101111a1011111a111110111100111111010101111110111111111111111101110111110112111200222112121111200221121221111111111011111111101010101110201221021021221100
0110110111101a0101011a110111111110111101110011111101011110111111111011101001111111111020202221112011122221021222100111110101111101101111111111101111111101011111
1101111011111a0111111a011111101111111011111101111111111011101010111101111111111111111120021022121112101012222210101111011111111111110111111001111111011111111101
1111001011111a1111101a111111110101111111111111111111111110111111110010110111111111122122021111202220122101112212111011111110111111001010111111011111111111101110
1101111111110a1111111a111111011111001101110111111010011111111010101111011101111011122201112101120202122101202121111110111110111111101110110111110010111101111101
1111111101110a1011111a111111111011111110111010111001100111011111111011110001011111222201210222111022110001112202111101111111111101111111111111111111111111111011
1110111111111a1111111a111111111111111010110110011101111011110001110111111111111112112012222122110122111112200011111110111111101111011111111010111101110111111111
0011111111001a1101001a111111101001111111111111111011011101011110111101100011011112222121122012211112122110220112100111101011111111111011101111101111111101011111
1001111101011a1101101a111111111111000011111010111111111110011111110101101111101112222212211012020211220112122012111011101111111111110110101111111111010101111010
1110101111111a1111110a111101101111110011111111110111111111111111101111111111110011212122112121220022101112212212111111101111111101111111100101111110111101111010
0111011111101a1110111a111111011111111101111111011011001011111111110111110111111112122222101221021121011222112212111111101011111111110111111111111011011011111111
1111101111111a1111111a111110011011011110111011111111001111111110011010110111111111122211220212112111111122001221110110111111011111111100010111110010111111111111
1111111111011a1111101a110111111111111110111000101111011111110011100110111111111101120110202111120101202221122220111101101110111100111111111111001111111111110011