14 42
146 113
144 10
120 82
132 17
16 98
71 36
118 115
155 104
115 21
1011011111011011011011111111001111110111111111101111111101111111010111111011111111111011111111111111110101111111011111111110111a1222210222110101111bb21211101121
1111111100111011110100100011111111111111110110011110111011111110110110101111101100111111111111100111111111111011011111100111101a0111221221011211221ab10101011201
1111111110111110011111111111111110111111111111111110111111111111110011111101011111011011111101111110111111011111101011210210210a1202122220222210022ab10110212221
1111111101110111111011100011111101111110100010010011111111111111111101111111110011111011101111101001111111110111100011122110201b1121012200112222121aa01111121121
1011010111111111111110011001111111111111101111111101111111111111111011001111111111111111111111111111111011111111111012111122112b1202202221021222202bb02100211110
0101111111111101010101011100010100011111111011110101011011111111111101111111111111111111110011111111111100111111111110112121201b2101021222222202221ab00211211201
1111110111110111101111111011010110111111001111111111011110110111111111111011011001101111011111111111012120112021022100210212222b2020212021222202221aa11021222222
1110111001111110111111111101111111001111111100111111010111111111111101111110111101101101001111111101210212102212121221022221022b0212222222212210210ab02202112222
1111011111110110111011111010101111011111111111111111101111111011111111111001101011111001111111111101221021100102111221022222222b0221110222222012221ba20121210200
0011110111110111111110011111011110111111111111101011011111111101111011111011111111111111011111111110212222221011211022020222122b2212002222222221122bb12222110211
0011111010101111010110111111100111110111111110001011111111001111110101011110101101111010111111101111111010222101112022022020212b2222110212222200022ba12212000221
1111111111101000010111100111111111111010111011111101100101110111111010101111111011010000011110111111110020202211111012102221122b2212212020121222221ba20102112201
1111111111111111111111111111101011101111111111111110010001111111111010010011111111111001111101111111012101122222101112220221021a0222121122222222010bb12112020222
1101111111101111111111101111111111111111111111111000100011111111111111111011011111101100111111111111122122211222220022221222202b2222222021212222222bb22111200021
1111010111111110111110101111011110111110111111111110101111101111110101111110111000110101011111111101111102210010011210012222222b2202022222121221212ba21102022212
1111111010110001011011111101111101111111001111111111111111111111011111110011101100001111010110110111022221212121212122222220002b2211221222222122200ba02211221111
0001111010001101010111111111110111111101111111110101110101111111111110111111101111111111111111101100220211211101012222022121202b2022121122111211222ba11012002220
1110001110010111111111111101110111011111111111010111101111111110111111111111110111111101111011111111211212222120200122022222122b2222221202222221212ba21222002210
1111101111110011111111111111011011111111110011110111011111111001100001111111111111111101111010111111222202211202022122220210012b2022212122010221221ba21012212112
1111011111100111110111111011110110101011101101110111111111101111111111011001011111111101110001111011200021222101121000021222110a2022210222111220020bb22210020212
1110111111110111101111011110011111111111101110110010111111111011111101111011101111101011111111111111022111211221021112201101202b2022122221222210002bb11011121211
0111111111101111101101101111111011111101111111110111100102012121211121000111121110022221111111110111120121012220121212021110202b2022122122220210222bb22111212121
1011111011111110111011111001101111110111101101111111111122111110201212101022220122111121111111010110221221220120122121220012222b2211212122121221201ba21112100211
1111111111011111111110101111111111111111011111111011111021110222000212120121211102111011111101110111120101202211222012222122202b2222020122021102222ab22200110220
1101111011011110111111111101110111111111001101111000111112221212100022201220111111220221101010110110010211121121000220020120212a0221222112221202222ba20010102111
1110111111111111110010111101111011111111111111010111111111200021121121111102220222002211111010110110021201221121111121222222101b1222202202021222212ba22020222202
1101111011111111111011111101111111111100111110111101010111102112111222121210021221221011111101011101122020101222022210122220022b1021221111002102121aa11111011111
1111011100111011111111110101111111011111111111111110111100202202212021112000112212100011111111101111112221211212111122100101222b1212022201221222122ba11111101111
1111111111101101111111101111111111001111111110011111111101211101110120211222202210211201111011111110111200002122012012222221222b0121120200002100012ba11011101011
1111110111111110111111111110110011111111111011111111111110202012022102112010012121222211111111111111220202021210002222101222222a2101110012012212211ba01111101110
1101111101011011111111111111101111111111111110101110011121111022111112102222201212202121100101110011201120220212221222222212221a2222211102212222221aa01101111110
0101110111101101111111111111110111111010101101010111101121112121210202210101110011210221111111111111011001201201122210102211211b2212011112101222211aa11111111101
1111101111111111111101110111001111111110111111101011111112210101012220011011112222222221011011111100202101220021211122222110112b2200202122111221112ba01011111111
0111101111101111111110011110011111101111110101111111100011011221112212210222220022112101111110111111210211011110012110222120122a2121111101111111110aa11111111001
1101110111101110011110111011111111110111011011111111110022101212011112221011211122122211111011111011211202211021012211122121122a1111111001111111000aa11111111111
0110111110111100101010101111101101101010111111111101100100200022112211221221121112101200101111111011010121122021220022111210222b1120111101110111111aa01111111011
1111111101111111010111111111111111111101101011111101111122021222211110021112212222222121111111101111022220101221022121201200111b2121111111111101110aa10101111011
1110110111111111101111101110111111111111111011111010101120122001222121101111211002111111110111011111001001111111111000000110111a0111111111111111111aa11111111111
1011110111111011101111111100111111111111111111110100111112210202101210221222022121121021101110111110001001110111111111111101111a1101111111111001101aa11111110111
1111110101001111011110111111011111111011111111111111101111101012221021112221121122111220111110101111111111111111101110110110111a1110011101011111011aa01111110111
1111111111111111101111101111100111111011111111111111111121102022022221020220002220212011111100111111111111101111110111111111011aaaaaaaaaaaaaaaaaaaaaa11001101111
1101110001010101010111101111111110101111101001110101100121221200101111212211102112011221011101111111111111001111101011111101111010111111011111111111a00111111110
aaaaaaaaaaaaaaaaaaaaaaaaaaaaaaaaaaaaaaaaaaaaaaaaaaaaaaaabbaaa111221120000122011112200110111101101111111101100111011111111101100111011110011110111001a11101111110
110111111011100111001111110110110111111111111111111100102222b100001122011222121211010121111101111111111101111101100011000111111111101101100110111010a10111111111
110011101111111110101111111111111101111111111101100111112110b112211222020022112001201220101111011111101010011010111111111111110010100100111100111111a01111011111
111110111001111111111111001111001011111111011111111110010222b221122212202112101111012111001011111101011111111111011011011011100011110111011111010111a11111111110
111111101101111111111111111101111111101111111011101111011222a202022011111122201121221201110111001110111111111101101101011111101111111011010110111111a10111110111
101101011011111111111111101001110111111111111111111101010200a110112112112101201121110001111011111011010111111111111111001111111101111111011011110111a11111111111
001111111111010111011101101110111111010111011000111111012200a120101211111021112021220221101101111111111110011110100111101111100111111001111111111111a11101101111
011110011111111100111111111111111111111111101011010110112121b212011122110102201122220121001011111111111110101011010110111011111101011111100111111101a01111011110
011111111101101111101111110010111011111111111111101111012111b110102221122212011111022101101110110110111111111011111111011111111110111011101111101111a11111010111
100110111111111011101111111111111111111101111111111111111211a121011121121010122202202220110100111111110111011111110111011101111111111110001111001111a10111111111
101111101111011011011110110110011111111110111011111111111111a011101111111011111111100111110101111111111101111111111111011111111100111111111111110111a11111111111
111111110110111111110011111001101110111110110111111111011111a101101111111111111101110110110111111111111111110111011111011111111111101111110111011111a11011111111
101111111111110111111111111101111100111101101001101111110111a111111111010111111101111111111111111101110101111101110111111110111011111111111111111111a01111110111
111111001111011111111111111111111111011101110111111111111111a111111111111110111111101110011111110010111111011111011111111100111111110001111111111011a11111101111
111110111111111111110101011101111111011111110111111110011111a111110111111001111111001011111111111110111111011111101110111111111111101111110011101111a01110111011
110011111111111111110011111111100111111111111010111101011111a111101111011111111011010111111110110101101111100011111110111111111111111011111101111011a10110011101
110101011011111011111111111110111011111011111111110111101001a111111110110101001011111111101110111000110111111111111101101111001010110111111111110111a10110101101
101111111111011011011110111111111101111111111111111111111111a111111111111111111111111011111111111110111001000111111111111111111111110000111111011111a01111111110
011011101111111111010111111111111011111101110110111111011111a1111011111111111011011101111111001011110001110111011110010110111001aaaaaaaaaaaaaaaaaaaaa11101100111
110101111101100111110111110011111111110111111110011111111110a0110010111101111111110111111111001111111011111100110111110111011110a1111111111111100111111011111111
111001011111111111111111110110001111111110111110111111111111a1111010111100111111111111100011111011101011111101111111101111111111a1111100110110111111111111111111
111111111111111110011111111111111111111110111110111110111111a1111110111110111110111111110101111111100111111011101111111111111101a0111111111111100111111111111111
110110101101111011110100110111111110111110111111111111111010a1111111110111111110110111111111111010111001101111111111011111111111a1111111111111011001111110111101
011011011111111011111010011100110111111111011111111111111111a1101110100111111111100111111111101110110111111111110011111011111111a0111111110101011111111111111111
100001000110111110111111111101010110110111101011111110101111a1111111111111101111111111111111011111011110011101111110111111111111a1111100100001101111011011011111
101111111110011011011101011111111111111111101111111111010111a1100011111111010110000110111101111101011111100022011221010120110221b0112211111111111111000110010111
011111101110110101111010111001111010111111101111111001101100a1111011111101111111111111110111111111111101121102121020221122221221b0022221111011111111111111111111
101111111010111101011101111111101111111111011101111111111110a0101111111111111111111111100111111100111100010102101012121020211201a2200201111010111111111111111110
111101101110111111111101110001111111111111011111111111101111a1001001101111111111111110111110110101111111001102212010212201021100a1212110111111111101111111101111
111111101111101110101111111110101111111111111111100001111110a1111110011011111110011110111111111111011010011210002112110120022101b1212112011101111111111111111111
100111110111101111111111101101111111001111111111101110111101a0111111100010101101111111111111110110101111101022212120201101000002b2101222011111111111011111111101
111011111111111100111111111111110111111111111111110111101111a1111110111111111101110100111111111111011101121102221020021011211212b2122101110111111011111111111110
110110111111111001111011001101111011111111111111011101011111a1111101111010111101010111111001111110111111100012212110201211211011a0121222111111111011111110010110
111111111111111111111101111101011011011101111111101101111011a1011011111110011111111011101111111100101011110221221112201211022102b1021120110111011111111101111011
110011011110101110111100111101111111111111010011110111111111a1111111011101111111111111010111011001111111111121220012201102122112b0201110011111111111111111110111
100111111111111110110000111111101111111111011101110111111111a1111011111111011110111111111111111011010111102222200212200210122112b0220111111111011011110111111111
011111011010111111111110011111110111111010111111101110111110a1111100111111110010111111111101001111101111112122110202022122012011b1212122011111111111111011001100
101110110111111111110011101111111100101111111001111011111111a1111111111100111111111111111111111110101110111221202012021222210110b1121110011111111110110111111111
011110010111100111011111111011011101001001111100111111100111a1111111100110111111101111111111111111111100112122122100021110002210baabaaabaaaaaaaaaaaaa11101101110
111111011111101101111111101111011101111111111111110111101111a111101111111110111111111111111110011011111111222102012001221122212002211221011111001111a11111111111
aaaaaaaaaaaaaaaaaaaaaaaaaaaaaaaaaaaaaaaaaaaaaaaaaaaaaaaaaaaaa100110111100111111101110111111101110111111110201010112222111101012110011211001110101111a01011111011
1121102111202112101211021011212111001111111101111101111111110110110111110110011010111101001111111010111111120000111212200101022111021202011110111011a10111111111
1010202210010210201122110022120201011111101110111111101110101111110111011111101111001111010111111111111111012102100110221002011201022222101011111101a11111110011
0112222112212222121022222210020011110111111111111101111111111011111111111111111100111110111111011101111101222221222210000020000021110211111111111101a01110101111
1102102202212221022122122101011011011011111111111111111011111011011011001011111101101111111111111111011002012111011111210212010221012122111111111110a11111111111
0221121020021121212221202222022211110001111110111111001101111111111111111001011111111111111101111111110101002022021121222021112121201221110100111001a10111101111
0020121212011202021120112212020211110101011111011110111111110111111001101111111010011011111111110010111111110112111202121221201101122212011010010101a11110111111
1111100211101010212111122001212211111111111111101111111111111111101111011111111011111111101111111101111111120221000121102012012021111202111120102022b11210211211
0122122201212110201011212112100211111101111011111111111011111101111111111011101101111110111111000111011111001121112100201100211022202111111111201111a11211102110
1211121222102221112211021211120110111110111111111101111111111111011111101101111101111111111111011111010012001111101220120201221121101220111021200222b20120201111
1120211121110221222110122111112211100011110111011111111011111010111111011111111111110111111110111101111112011121121211002211112010110121110101121212b01210111221
1212121220201112011112121221122111111111111111111010101011111011111111110111111111101111110111111011111111112221012012101012210000112122010022212212a11212111210
0222121011001011020111221110121211110111111110111111111110111111111111101110111111111111101011111111111102022122201101222220121121220211011122122012a00212112010
1110122222102212010112212111021210011011111111111111111111111111011111111011110111111110011111110111011101212012212211221110011212122121110121222011b11022112112
1211212221010110211122101121121111101111100111111111111111111100110111110111101110101101110111110111111112212221112212022201112212001110011111212000a22221221121
0202111121022201122221012210222111111101111100111111111110111111111100110011111101111011011111101101111112211220121010101202122002211022111112012121b10211221002
1221221220122121110012122102122110111011000011111111111111011011101111111111111111111100111111001111110110111111110111111111111111000111011122221011a02011111111
0111222022122211212121101211001211111111010111110111101110111110111110111111110011111111011111111101111101111101111110110110101001011101110020110122a02110200201
1111220221112022111221102200111210100001111100111111111111111001111011101110000111110101110111100110111212222112122121222102010001212211111101212010babbbbbbaaba
1122111021121112212011112220201211011110111110111111111100111111111111111111111111111111011111111111110222002200022101212120110011122111011110212112111211121120
1122222120212200210010211221122111111101110111101100111111011011111101110101011101110111111101111111001100101212212122022122221011022011011101111120000110112111
1122122120000111111211120112112110111100011111111111111011101111011111110010111111101111001101010100111222212111122110102221111211001011111021102202110202221211
1112010100211121112101021101212111010111110101111111101010011011110010101111101111111011111111011111011112201120112111211010212221021111111122212102111012201122
1212201222222212101212222011212211101111110110111111111111111011111111011101111111110101111111111101111012110022022211212221222221200010111111022101100112121212
1111112022022211112220122222121211110111110101111111101100011111011011011111111111000111111111111111101110210200111201211111201201011010111122122222112201021111
1112212110202112211021221122111211110110110110110100111111111111111010101111111111111010111110010111101210020202112221101212121022221211111121201200202212221210
1110212121222002200010210111121211110011111110111111111111111111011111011111111111101111111111111111110222220112211121012121111211111211011122112222111202022212
0101112110112220220211212010122211111101111111011111110110100111110110111011111111001111111111111111101012212021100012212110021202002201101101021112222120112222
abaabaaabbbabaababbbaabbabbaabaaaaaaaaaaaaaaaaaaaaaaaaaaaaaaaaaaaaaaaaaaaaaaaaaaaaaaaaaaaaaaaaaaaaaaaaabbbaaabbababababbabbabaabbbaaaaaaaaaaaabbaabbaaaaabaababb
1202202122112221210102120211111111011111111101111010110101110110101110111111110111111111111111101011011211201211222212212122101212220211111012201121111220022112
1102221110111221102212122200010010111111011101111101011110111111111110111111001111111100101111010111011101210012021210221111222002212201111122102122112121211111
1222112022002200201021012220211211101111111111111010101111011111111111111111111111100111111111011111110120112111112212111202122211111210111112121122110021101211
1101111101100100101111110111110111111111110101111101111111101111011111101001110111111111111111110111011101212022111202122001112221211010111121112221012211112202
1101011110010111111110111111110101111111111101100010111110111111111111101011101111111101111111110111111201002221122112210120112101202111111121021122121102110222
1111111101101111100111111101111011101011111111011111111111111110111101111111111111011011111111110101101021212011212201111122120111100101100111121101111221212212
1111110111011111110011111100111110111111111011111110101101001011101111111101110001111101110100111111101221122210210022121120221212220211110112012110110212220221
1111111111111111110110110111110111111011111111111111010110111111011111111110111111111111101111110010111101112121200210001220111200111011110111212212022112112110
1111110111111111111111011111110100111111111100111011111111100110111011111111101101011111111001111101011201012111212222221221020200021210111111212221021220222210