87 101
159 10
18 118
26 58
36 111
38 85
109 60
76 36
100 31
19 84
01111010111110011101111111110110111111011111111111a1111101111111110110111111010111101011101011a0111111101011111100111111111111110111011010100111111111011110011a
11101111001111101111100011111111111111111111000111a1101111111101110101111110010101110111111111a1010110101110100011101110110111001011111101111111111011011111011a
10011110011101101101111111111011111101001111111111a1111111101111001111111011111111101111011111a1111101111011111111001101111111111111110111111011111011010111111a
10111101111111111001111100111101101110011111101111a1011101111011111110111111111111111111111111a1111111011111101101110111111111101100111011011111010011111100111a
10111011111111110101111101111111111111001001110111a0111110111111111010111111011011011111111011a1101111100111111101111111111111110111010101101111111011111111011a
11110111111010110101111110111001011111111111111111a1011111100111000111111111110111011011101111a1111111111111111101001111111111011011111111100000011111111101100a
01111111101111111111001111100011011101111101101111a0111111011111111111100111110110111011110111a0111110110111110101110111111110111011111111010011101111101101111a
00110001111111110011111111111111111010110011111111a1011100111111101111101101011111111101110110a0011100111111111111111110111111111111111111101111101101101111111a
11111101101111001101111111100111101111111011110111a1011110110111001111111011111111001011110110a1111110111111101111100101111110101111111110011111111011110110111a
11111011011111111111111111110111010111110111010010a1111111111111111101101101111111111111111101a1110111111001111101111111110111111011111111101011110001110101101a
11111011101101111100101101111011111111110111111111a1101010111101111101111010111111101011001101a1111110110111011111111111111110111101110010111111111111011101111a
11111111111111111111011111111111111011111111010100a1101111111111110111111111111110111101111111a0111111110111001110111010111101101111001111111111111101111011111a
01111101111111101011101110111111011010111110111111a1101100011111110111101111010011110100011011a1111101111111111111110110011101111100111111001111010110110101101a
00111111111111111111111111110101111101101111111111a1011111011001101101110101111110110101110110a1111111111110001101111111111110111101111111110111111111111111111a
01111111110100101111111110111111111111110110111111a0101100111011110010111111111110101011111111a1111111111110111101011101101111011111111101111011100101111001111a
11111110100111011111101111101111011110110111110111a1111111111111111110111110111110111101011111a1001111111111101110011111010111100101111011110111111111111110111a
11111101111111110110111111111111011011100111010110a0111111111111111101100011010110110100101111b2220102121222112111020101111011111011101111111101111111001111111a
11111111111110101111110111110111111111111011111111a1011110110000011111111111111111110102211112a1122211221211012022111111100101111011111100111111110111011111011a
11100111111110111111100101101111111111011111111110a0111011111111011111110101110111111012112111b0112212221122102012211111101111111111101101101101111111111111101a
01101000111111101111111101111111111111111011111011a1001111111111111110100111111111110221220222a1220200211121120222221011111111111101011100111001110111111111110a
11111110111101111011111011111111111110111111011111a1111100111111111010101101111010101011211022a2212021111111022111101111011010111111101111011111101011111111111a
11111111110011101111111111110111110110101110110111a1111110101012120212011211211202121220021101a0002212102112111221211111010101110111011111011011110011111111101a
11001100011111111101111110011111111101101111111011a1011110111211201121200122111121112102222210a1211021212111022020210111111011110011011111111101111101101101111a
11111111111011111111110101101111111100111111111101a1111110011221121012111101212121120122110021a2111102220121011012121111111110111101111100111111101011110011111a
11111101110111011011011111111010101110111011111111a1111111101022121012011101121110110020220202a2201012012122211211011001111101111110011001111111001111011111110a
00011011010111111000100111101110001111111111111111a1100111011212222022121222121112211010122221a1011122120121112102011111111111111101101111110111111111110111011a
11011111100111111111111111010111111001110111111101a0100111111012120202022220011121212211221211a2212211120121100120121101011010111101111011111111011101111111011a
11111011111001111111111111111110111110101111011111a1111111111111120211122110111201110222222112b1111121011221010202021111111111111011011110111010111010111111111a
11101111111111111111111111111111110001111110011111a1101111011121221212121212221022022222202202a1121211120112212011111100010111111010111111111101111111010100101a
11101010010111111111011010000111011111001110111111a1111111111112111101221020222211122202202010b0122111011101020122211100111111100111011011111111011110110111100a
10111001001111111011111111111111111111111111001101a1001111101212121210212021212211101222122020b1201201101111121000111111110101111111111111111111100111011111111a
11111010111111101111111011110101111100110101111110a0111101110222122022211120211220012222201211a2020222122202122112121100111111111111111011110111011011111011011a
01011111111111011111101100111111110101110011111111a1111011111201221111220212110202211112201112a1112211100112221202111111111101110101111111111111010111101111111a
11111111111011111011011111111101111111011101111011a1111111111012211101002212210121222022222221a1201212211211012101121111101111111111111110111111101001011110111a
11110111101110110111111111111010100010100111011111a1110111111221221011012121212110002202212101b2210202112111221022111101111001111111011111111011111101011101111a
01111110111011011011001111111101011001111111111010a0101011111121201211111112022222120222202112a1022221212211210221111101111111110111110111011101101011111101111a
10101010111111101111011111110110110111111111101111a1011011101201212022001022210101111020222210a2222211012221102220201011111011111111111001100111001101101111111a
11111111011010011011111111101110111101110111011111a0111101111200110000112112121211102221002220b2111201221221112211121011111101111100111111011111101111111011111a
11110111011110111111101111101011111111111111111101a1101111110221222121212101121211110201222021a2211011020122122221221111111111110011111110011111111110101101111a
11111111011010011111101111110101111110101110111111a10011111111202110002121aababbbbabbbbbbbabbba2102222210202112010111111110111101000011110111111111111010111111a
01111011110111011001110111011111110111111101011111a01011111110202102212122b021221020110222221201120020222221211201120011011011000010011111111111111101001111111a
11111011111111111111111011011111111001111111011111a10001110112112111002102a221012001120222221020111112012221222111221111101111101101110101011110111111101101111a
01011101111111111111101011111101111011111111010111a11111111112201121100211a112022122121222201120211111110212212212121110111101111101111111111111100011110111011a
10111111111112110112120112212102110022021011110101a10001111112101111112200b021122122102022101201021022121000011111221111111011111101011101111111011111101011110a
10011111111122111210021210221212211201202001101111a10101111110120111012211a102111112020221212021210202011100012122201111101110100011011111111011111110011111110a
10111111111210222112211101220101121121221010011111a01111101112011201222012b212211110001102222122202222222201112220220101221120110111111111111111110111111111011a
11111111011111221120122012221112110000210111111111a11111111100000112212101b211200120222221011112111212212222220022211111010220011111011011111111110101010011011a
01111111011222212110212022110002121102011011010111a11111101111121121211111b011121222110120211111211110221110102020202122112101111111011011111110101111011101111a
11111111111221112201220110011112011111110201111011a10111111111221112011222b210121102111012020112121201221112211200101101212121010111101111111101111111101110001a
01101111100020212011020012021220201212100111111111a00100111112121120100120a001102221111211111112121012121222222122221110101111111101111111101100010111111111000a
11111111111221112101101112111001112101102011111001a11001111110101121221112b021110021112121121000111202221102221110222110221210111011010111111111110011011111111a
11011110111121222121111222112212221201112211111111a01110110102211211112222a221200111222111020011122110111221221222212122221220101011111011110011111110111111001a
00111010110121211101110111122212202112111111100111a11111111111110111110010a101111011101110100022120212202212111222121222011121110111011011101111101111111110111a
01111111111220122221022222211221221201211210111111a10101011111110011111000a111111001001111011101212010211220212021211112222201111111111111111111001111111101111a
aaaaaaaaaaaaabbabbbbbbaaaababbbbababbbaaa211110111a11001110110101101111001a111110010111111101122201121012202221211010211212011111111111110010110111100110111110a
1111110111112100111120111111011211220122a211100111a11111010111111100001111a110110110110111111102212101120011100112112221121211011111111111101111100100001110111a
1011010111021210102212111122111211122221b011111111a11111111111110111111011a111111111010111111021102012112221111112222200221221110111111111111111110001111111111a
1111111111121022121222012222211122201120b111111110a11111111111111110101110a111011111111110111111022010222001221110021222112111110111100101111111111111111110110a
1110111111121211222110201101211200112112a110111111a11010100111111111011111a111111011111111111122121010120011220001210221211211111111110111011111111011111111111a
1111110111110022200211112022221102220112b111101110a01011010010111100011110a011111110111111010101001212221210212221212022122101001110111111111111111100111111011a
1111111111121201220121112202222122122111a211111111a11111111011110101111100a111111111111111111112122222012121122001210122002111101010101111111111111111111111111a
0101111111012112022122210010212121222012a101111111a10011111101111010111010a101111111010111100110211022101121221121220212122211111111110011111010111101111111111a
1110111111121221202222111101120212022101a211001111a11110111101011111100011a111111110110101101102211011222112222012101112122221100111101111111111111101111011111a
1011100101022010112102101110220212012101b011111111a11111111111010010110110a111111011111111111000211022211120112221201220221221011111111111111111111011100111111a
1111011111102102022222222110222210110121a211011111a11111111010111111111111a111011111111101011101211111120122201122221111211111111110110111110101111111011011011a
1111111111121112111222211000211221111110a011011111a11111111110111111100111a111111110111111111121211121112211222121221122110111111111111111111110101101111111101a
0011111011122220101120201212022111220210a011111111a11011011110111011101011a010110111111111110101002020112102110122222221211121111111111001101101110111111111110a
1111111111121221001111222121021022112120b211111011a11111111011111010011011a001110111111010101100122110021201001212012010202111111110111111111101101110101111111a
1111111011111121102221211121011012122222a111111101a11111111011111111111110a111011110111011100111211020101211112210221212212211111111101111101111111110111111111a
1111122212122212212112020121021100222200a111101111a01111110111110110111110a111110101101111111122112020012211012122121111021221010000111111111111101111111010101a
1011101210022222222201112222002221222121b211111211a22011111111110111110111a111111101111111110102120002122212101211212121121121101111101111111110110111111111101a
1111111110122220120212122222222112212222b201121102a12211001100010111110110a100111101111111111021010201120100210022110212112011111011111111011111111111101111110a
1111112121101021112112220210221020222212b221212111b22110101101010110110101a100011111100011000112121202211012022221112122121221110111111111111111011101111010110a
1101202121222221222012020210120222200122b022211221a01211111011010111110111a101111111111110111110222020011121101211001221120111111111101011111111110101001110110a
1110122220210012210200212201011200210212b122202211a12011111110011110111111a011110011111111101022112010120211201021222221111121111111110111110011110111111101110a
1111211111201220112211222222122222012101a102111210a22011111011110111011101a111100101111110111121121012122110202200201022122110111111111111110111101011111111111a
1111021221121201111111221122201112222120b122201211a01111011111111110011111a111111111101011100101011001110111111111101111011111111111110111110111110001110101111a
1111100112011111222211222221022100212111a110020211b20101111111111111111111a111110011111110110110111111111011010110110110110111111111101000111010011111110100111a
0111011011222121110101212211120212201121a220222011b12211011111111101111111a011111110111111111111111111011101111111111111110111111111111111011111110111111111111a
1111211021011202012121120121112122201221b221122211b20201111111111110111111aaaaaaaaaaaaaaaaaaaaa1111101111110111110111100111101011100011111001111011111111111111a
1111111020201112202001212022222022011021a202221202a1011101111111111011110110111111111111111101a1011001111111011111101101011110110111111111111011011110101111111a
1111011221111120011211222211222122210112b112012211a1211111011111111111110111011110110110111111a1001110011111111101110111011111110111100110111011111011111111111a
1101212000102201111121221101112222121102b220111211b1111111011111111110010111110101110111011111a1011111111111101111110111111011100011110101111110111110111111111a
1101210221202202111122111122210022211220a211111211a1001111111111111010101111110101111011111111a1111111111111111111111111111110110111011111110111111111111011101a
1111110121111221220122012112211210111010a212002122b2211111111011011110101111111011111011011111a1101111011111101111101111111111111111111111111011111111101110111a
1110121211022020222121201210100122122001a211221201a1221101101111101111110111101101111111111111a0011101100011110011111111111111111111111111111111111111111111101a
1001102222122120111022012020222222222101a100111122b1110111011111111111110111111010000111111111a1110111110101011101101100111111101111101101111010111111001011101a
1111211110111201120111201021012122212221a021110111a2211100111111011011011101001011101111011111a1101000111101001110100011111101011111001111111011111111110111111a
1111022121212112112112202122221122221211b112212122a2111110111010111110111111001111000101111111a1111110111011110010001101111111111111111111111111111101011101111a
1110222012200010202102212220222002212011b220101011a2110101100111111101010110111110101111111111a1111111111111111101010111100101101010110111111111111111111111101a
1111211200102210222112121022212212222111a210101122b2111111001011110111010111111111110101111111a1111110111100111111110011110111111011111100011011001110111111111a
1011202211211120122212222220221222201110b221112202a1021111100111111101111111101110111111111110a1111111111011111011111111110111111111111111111011111110101111011a
0011121201101222212111122210120110221220a101112012a0121111111011111111110011011111101101011111a1111110110110111111110011110001110010110111010111111011100010101a
1111200011212210121100212222222222221221a122220022b2211111101111010100101111101101111111011011a0111101111101010101100011111101101011111111011011111110111111111a
aaaaababaaababbbbababaabbabbbbabbbabbabaa111121222b1211110011111111110001111111110111111111010a1111111110111111111110001001101111111111111111101110111110111101a
11112012121121122222122020222222212120112011111121b2101011110001111111111110001101111111111110a0111011110111110111111101101110011111111011111010011111111111011a
11101120210222122011220200222222022022212211201222b2011111111110110111101111111111001110011110a1111110111001110111111011111111111111111011111001111111111111110a
01011101111101222021020222212220220221000221222010b1121110111111111101101111100110111111100011a0111011111110011111011011111110110111111010011010111101111011111a
11112201112211122110222222200222202020222021202122b1201110111011101011011011111101111111111111a1110111111111111011111011111111111011111100101100111100111111011a
01012110201221202112021022020021220212211012222222a2021111011110011111111110111110101111011111a1101011011110111111111011101111111111111011111101111111111011111a
11111010111111011111102220222222210222122222122222b2110110111110110101111111111111011101111100a1001110101111101111001010011111111001011111111100111110111111111a
10011010111011111111102110102212222021122021112222a2011110011011111011111100111111111111111111a11111111000100011010111101110111111111111111010111111111111111011
11111101101111111111110220111120211002212022121220a2111010111111111111111000111011101101111110a01111011111011111011111111111110111111111111111110010111101111111
11121122201110201021222210122122222121112122201001a1111111111111111011010011101110111111111101a01111111110111101001101101111111011111111110100001111111111111111
11122221221012110221212201202200222220221001012202b2101011111111111111110110111110101101111001a11010111110101110111101010010111111111111100111111111111111111111
11121012100221212212121022221021220121121021111102b2111110111111111111110111010111111111011111a01110111101011110111100110111101101101101101111101111111111111111
00012111112120121020122222212121200211121212102212a2011100111110111111111111111111111010001111a11011011110111111111111111111111101111011111111010111111011110111
11121212222211222020202102222102201111120220122011a2111111011111101011111111101011110111111111a11111110111111101111101110111111111111011101111111010111110001111
11010222101211122222021200102202022102221020220221a1011110111111111111111011111111101101010101a11101011010011011001101110111111111011110101111011111111111000111
11102111212012212211221221022122021202111111022110b1101111111110101100111110001011110111110111a11111111111111111111011110111010111100011111111111011111111111010
11122211202201022112212120110002210212121020122222b0110111111111011111111111110111111101011111a11110111111111001110111011111111111011111111011110101111111101111
10101021202201112212220220120221212010221222100211b2000111011111111111111110101000111110101111a11111011111110011111111101111111011101110011011110101111111111110
11112011121211121121022220202022010220100122210112b2111101101110011101110011111101010101111111a11111111111111111111111111111101110110011111100111011111111111101
11112121221111101002022222220221000122010021012011a2101111111110111111111111110111101011011111a01110101111111011110110011111110110011111101011001111111111111101
11121112111202222211222121222022201222012221111121b2100111111111111110101111111101111011111111a01111110111111111111111111111011110111111111001111111110110111111
01122001112212120111222022202102221221222012001021a1111101111100111111011111111101001011111101a00111110110110111111111111111111110111111111111100101111111111011
00101222012121222001120212122122221011202011211202a0010011111111111111111111110011111101111111a11111001111110001111111011100100110111111111101010011111111111011
10121111121121022212100221212012012121200220221121b1111011111111111100111111111111111111111111a10111110111111101111110111011001101111000110010111101111111111111
11122110212122011211112222212222122222011211021220b1111111111111111010011111110111101111111101a11011111111111111111111110111111111011101111111111111111111111111
11102121112111110101122122222022221201222122200111a1111100010111111111001111111111000101111101a00110011010011101111101111001111111010011110111111111100110110111