156 26
58 1
51 50
145 19
124 81
117 22
104 11
102 96
159 88
16 90
11111011011111111010a10111111111100111111110111011010111a110111111111011101111011111111112112100b211200100212111111212201111110101101111111111111011111111111a11
11101110011111110111a10111011011110011111111111110011111a110111100111111110111111110110102202102b022121112211120022122211111011111111111111111011111011111111a11
11111110111111111011a11101011011111111010111110111111101a111111011111011111111111111111112120222a110122221111011211121121111111111101111111110111111111011111a11
11100111111111111111a11111111110111111110111010111111111a011101111111011101111111111010112212202a122012121112212212121121111111101011011111101001101111111111a11
11111011111111111111a01111011110011100101101011111110111a011001011111110001111111111111101022120b222111200221000111011221111011111210102212121211221221112111a01
11111111111101101110a11111011111111101011100111110010101a111110111110111011111111110111111201022b221221001012222211210100111111011022110110120210111222211111a21
01100011111001011111a00101111101011111110111101111111111a111111111111110101111101111111100011200b112222120202122002121221111101111201012022111000202212110122a22
11011111111111111111a00000110100111101011111111110101110a111111111110101111011111111111110202120a212112222211122221102011222021112202011221011002201112002001a01
11111111111111001111a10010110111101101111111110001111110a111111111111111110011101111101102120012b111222020121121210220022111202102021222221121212211122212112a10
11111111101101111101a01101111100100111111111110111110111a011111101011111111011110101111110112021a211112220022222210221212122102212111211112200111221222222010a22
11100011101101111111a11111011111101011111110010101100111a111011110111111111001110111101110222221b112211000212202222112222022110222222211022011121220012120210b22
11111011101111111110a11111110011111111011111111111111111a111111111111111111101111111101112122200b000202202100101020220211101121101202000021120012222210202221b20
10110111111111111111a11110110110111111111011011111111111a111111010110101111111111110111100011010a022012221222202002222221112212122222220210212022211210221110b12
11110111111110111111a01010101110110011011110111111111101a111001101010111111110111101010111010112b122111122022220200220201112200112220200221212102121021101011a11
11111011111101111111a11101111110111101101011011110110100a001010110111111111101111111111111110012b211020100221210222122221211112020020220220211222220121112211b22
11111011011110111110a11111111111110111010111011110111111a111111101011010111111110101011111211222b012010202221222100212021012021112222112000122111111210102011b22
11111111111111111111a11111111111101011000111111111111111a110110111111111101100111010111011112001a211122201211122022220221121111220122202020121122201212211221b21
11000110111001101011a11111111011111111111101111011111111a111111111111111111111111110011110200022b210200022011012222120221221110101202111222212211121111000022b22
01111011111111101010a00011111111101110110110111100011011a010111111111101111101111111110101212222b112212001202220221212012212112112122201122211221102021002220b22
11111101101111111111a01011101011101101111111101111111111a111111011111111111011011011111012120212a121010012020202022212202122221220122101222022120111111120221b21
01111011101011111111a10111111111110011111111011011110011a1111011111010001111aaaaaaaaaaaaaaaaabaab211211222222222202211210022111211210112222102101120121212021a21
11010011111111111111a01111011111111111111110111011111110a1111101101100111111a11010111111010201212022022002222220210222201012102022220211112102201202202112211b20
10111110111101101111a11110101001111110111011110111010111a1110111111111000111a11101011011112102121210212212100022112220221101122111022211012102221220221122202a01
11111001111110011111a11101001111101111111111011011111010a0111011111111111111a11101101111102102111220211122212212212211221200221112212210122111112122120110212b12
11111010011111111111a11111100011110101111111111111111110a0111001111011111110a01011111111111220212222022222102212222220121111222221022011212021112111112121000b12
11111111011111111110a01011001111010101111111001111111011a1001101111111111111a01111111111122201211022222022202122212221121002211102102111202011201101020010222b11
11110011101111111111a01110111011101111111110111111011110a1111011001111010111a11111111111111212122222022222012222220202212012011121210211121111122220211220112b21
10011101111101111001a10111111111100011011111111011111111a1111011011110111101a11111111101011111101001102221211201211011200102012221200201220112112222011112202b21
11111111011101000110a10101011101110101111100011110100111a1111111011110011110a11111111111111011111011111022221121101220121121200221222111111100101011202201202a12
11111101111101111101a11110110111111111001111111111111111a1111010111111111111a01111111011111111001110100221111211212212122200121201222122011112101221212120201b11
10111000110111111111a11000111111111101011111111111111111a1111101001110111101a11111111111111111111010111121020122112220101111212222211001121122121201022222111a21
11111111101101111101a11111010111111011110111011111111010a1100111111111111101a11111001011111101111110110011021122211221102102110222102211012110121201222211212b01
11111111111111101111a11111111110111111111111110111011111a1011111110111111110a11111011101111111111110112222222201011211122112121211001112121021210221212202220a11
01111111111110111111a11111011001111110111111111110111111a1111111100101111111a01111110001011101101111111101101111101222112102212221122201121222121221221122221b21
10111111111111111111a11110110001101010101100111110111111a1101111111111110111a11110011111111111111111111222200001102211220121121021211221122001110202022101100b22
11111111111111111111a10111111011110121121012202211021221b2022210011100111111a11000111111111101010101112021022222210111220221111110120001001011111011111101111a11
11011011011111111011a00111111111011122112002111210120011a1222221201011110111a11101100011111111111011112121211011112121212012121022011111011111111111010100111a11
10110011011101111111a11111111111111110222011102111212112a1121121211111110111a11111011011111111111111112100011111021111012121210210221111111111110011111111111a10
11001111111111111001a10111111111001112111022202121112022b1011122221111111111a10101001111101111101101001110110111111111111111111110111111111111111111010111011a11
11111111011011100111a11111101011111011202110102121220022a1201122220111111011a11111111011111111111111110111110000110101101100110110001111011111010111111111110a11
11111110110111111011a11110111111111122001212221211100211aaababbaabbaaaaaaaaaa11100111111111011010111111111110111110101011100111110111101010011111111111111111a11
11111111111111001101a1111111001110102100221201111221220221222111112111111110111101111111111111011111111010011110111111001110111111100101101011011111111111110a01
11111110111100111111a1111011111111112102002112221212110102012110112111001101011110111111111111111111111101110011111110101111011001111111111111011111111111111a01
11111101010111011101a0011011101111111212121222012201120122222202002110111111101111011111110111111111001111111111011011011101111111101011110111111101111111111a10
11111100111011101110a1111110110111110102202112221000021122220212210011011011110111111111111010110101111101011100110110101111110011111111111111001111111011110a11
11111111111110111111a1111011110011011012211202110222021122000110122101111111100111111110111111110111111111001101011111111011111101010111011111111111111111101a11
11011110111101110000a1111110110011112112211121210122111220122202021111110111110111101011111011111010001011101011110111111110111111111111110011001111110110101a10
10001111111000111011a0110011111111112211002122102121111211121102221111111111111111110111011110110101101111110101101111111111111011001111101111101101101111111a01
11111111111011111111a1111111111111112200022222121220102011221221102100111111111111111111111110111011111001011111101111111011111111111111111110111101110111111a11
11011111111111110111a1111111111111111212001210112101112111112210102100111011101111111100111011111010110110111111011111101101110010111110101111111111111011111a11
11111101111101110111a0111111111111110221122112111122100011212211122100110001111011011100101111111010111111010011101011001101111011011111101111111011010100111a11
01111111110011101011a1011001111111101112022011001200121221021100002111101001011111111111111100101001111111111001110111111111111101101111111101111101111111110a10
11111011011111111110a1101110101110111101012222021012121001111200211111111101111111111011111111111111111111111010110111011111110110011111111100111111011111101a11
01010111111110111110a0111111001111111111212112001210212222002202122111110011101010110110011111101101011101111111101111011110111111110110011011111100011111011a01
11011111110111110111a0110111001110100221112202120021100210212201110111111101111111111111111111111111111011111001111111111110111111010111111111110111111111011a11
11011111111111111111a1110101101111111110002101021122220220201222102010111101011111111101111111111101001110110111111111011111111111111111001111111111111101111a11
11111110111011011101a0111111111111110122120022121220112221210111222111111111111111111111110110111110101111011111011101111101101011110111111110111111111100011a11
11110111111111111010aaaaaaaaaaaaaaaabaaabaaaabababaaaabbbaaab101020100111111111111111111011111111111010111011010111111111111111111001111111111101111110110110a00
111110111111111111111111110100111111222121202111122222122012a222221111111111110111111111101011101111111111111101101010111111111011011110101111111111110111111a11
111111110101101111101011101110111110122221111222021110112012a001120001101111111111111110111101111111111111111111001011101110111111011110111011111101111101011a11
001111111011110111111110111111111111001222222111210221122020a101002101111011101110111111111011111101111010111111001111101111111101111001111111111001001111100a10
111111111110110111111011111001001111112212112111021202120112b202211011111111111111011111111001111011101101111110111101111111101011110011111011110011110111101a10
111111111101111101111111111111111110111122022201120211210222a210121011000110110111110111111111111111110110011111101110111111111000101111111000101110111111111a10
111110011111110111111110111011111100222222112211220121020201b021120111001101011111110111101111111111011111110111101101110111111110110000111100110100111111011a11
101001011111111111111111111111101101121212022020221201210220b210121111111100110110010011111111110111111111110111111110101111111111111111111111111111111111011a11
110100010110110111101111011111101111212121021202122110212201a221222110110011111111111111111110111011111111110011010111111001111011011111110010111010110111001a11
111110111111111011111110111111111111111111111011110111110110a111011011001100000111100111111111100111110101101210112022222112102222121222221101111111111100111a11
111111111011100110111111111111111011110111111111111101111111a110100101111111111111111111010111110111110100111212011210211202122012121001022111111011100111101a11
101010010111101111111011111110111110101101011011111111110110a011101111111101111111101111111011101111111111111021011211120011101112211220111210111111011111111a11
111011101111111001111111111011111101010001111110111111111011a011011010010111100010111111111111101101011111101121002201211122210201221011100211010111111111111a11
111011111011111111111100011111111111101111110011101111011111a010111111111011111100100110111101111111111111011111110210012111111112122212220011110011111011111a01
111111011111111111111110111111111111111111111111110011111110a111111011110111111111111111111111110111110101011201112110101120120111210111112211100111111011111a01
111101011111110111101111111111111110111101111110111011101001a110101111110111111110111001111101111111111101111111220012011212100002211022211111111111111111111a11
111110111000101010110111110101011111011110111110111111111101a011110111111111111111101111110110111111111110111220120202122022221102221222210110101210111121112b21
101110001111101011111111110110111011111111110111111011111111a101111111111101011110101111011110111111101101010022210122210201212112222221111011111211222211120a11
111010111211221210121220221112121011101101011111111111110011a111111101111001111010111110111110101011111111101212111211110221210121211021102110100122212212011b10
101022111221221022221202111112121011111110101111001011111010a100110111101111110111011111111111110111011111111220222121012122210111111112111010011222200210200b00
ababaabbbbbbaaabbaaaaaaabbbababaaaaaaaaaaaaaaaaaaaaaaaaaaaaaa011111111011110111111111101111111101101111100111011212202120220010102101110211211102112211121211b12
1102000222220221112110211212111111111111111111111011011101111111111110011101101010111111111110101010011011101202001221201122221110011022011201110101122222112a22
1112201212212222202111122222001011111110111111111110111010111111111111111111110111111111111111111111111111011112122112221021120202212112100110111210221101122b21
1122112222021122222202101001002111011111101011001111111110101111101101111001111111110110111101111000111111111211222121111220210200211212222211110101221210210b21
1211100011111212112010110100022111111101111101011111111111011111110111111111111011101110010222221112122022121202122201212010001212111210112201101122110211012b21
1212211122111022221111122122222011111011100111111111101111111101111111111111111111111011112122111210211211111101012202202110222112101111112210100102112121121b22
1101111122122120122121212102000011111111001111111111111111111111101111111111001010101110022121022001211012021222122221110221212221221200101111012210210022122b21
1112111022122221100112111222222111111101101011101111110111111111110111111111101101111111211110102122211121112220110012200012101012100222212110111022122212211b22
1010120121121201212022202011102001100111110111111111111111010110001011111111010110011110121100210212111111221020222000012222221211012221221211102021102121212a20
0221112111221012121211211010210011011111111011111110101110011111111111101101011110111012222201120221000222001222122222121121221111021212222001011002221112022b20
0020102112121211121121201012221111011101111101100111111111111110110011111111111101101111121202211222221120212202110212102012221102122211111011112111110112000a02
1210212211101110211121112122012110111110101111110101111101111111111111001011111111111112120121022221120122210022222222221211021100012221222110100210012200212a10
1010010011211221201121112201121101111110011011111111110110111111111111111111111111111111112112102222121102112222222021211011210020022102221111111111002200022a22
1110212011110120121221221112222101111011111001111111101111111101011011100110111111101111201211221021002122122111112202211020221021222201222211102112212110210b11
1012111021211120122121222201212111010111111101110100101100111111011110101110111111111112001221212212221100211212020000122022110222111122012211111112212121012a01
1112121212110001211122112212121101101111011111111111011110111111111111111111111111111001010112011220111111222222222212122110110112222211220211001020102012222b10
1002112121102110112212021112121210011011111110101111111111001111110111111110111111111102110120102100222220211222021202021111111211202012121201112210021121210b12
1102221021221121222210002211022211011111111110111111111111110011111111110111111111110112022120220021201002111221212222112212112212121111221111111201210022222a10
1201001120121021121001111202112000111011111111111111011111111111101010101111111110111102112010021200221102201202222012111120100021212222221110010202221110201a22
1211211211222202022111111122111001110110111111111111100011110111111111011100111110111010221212111222120021100222221110011222222211002211112100011101101210100a21
ababaaabaababbaabbaaaaabbbabaabbaaaaaaaaaaaaaaaaaaaaaaaaaaaaaaaaaaaaaaaaaaaaaaaaa1110011201112102111121110111112211102111111101111111011111001012222210112001a00
12222022210211021211221122122222110101111110111111111101111111111011111100111111a1111110211200222021101211212110211211111111111111111111111011111011010221021a21
12211212021021122111222122000121111111110110101011111111111111011111111100111100a0011112112000121202121220222010122211111101111111101111110110111112001112221b21
02101101201102111011201002201212111111111110010111111111111110010110011011111111a1110012100221220112022121021112222020111111101111111101101010112102210200020b20
12221122202021221022122122012220111001000011101011111111111100111101110111111101a1111110002021122122202222102011120212101100111111111111111111112021212211111b11
12111221011202210121202102111101111010111111111111110011110101011111111111110000a0111101212210221201211121020100211111011101111111101011111111112220212200010a11
11122222022222111121021102112101111110111111010111110111111011101111111101111111a1011112111122010112110021221122212211111111101111111011011101112121021202021b21
12200012220121222011122022011201111101111111110000010111011111011010111110101101a1111112212210221221121221111210101110100101111001111111110111110111111110110a10
12022211202112111020212222002111101111010111110101111111011011111011111111111111a0011111221221122112000101221002121210011011111111111111111111111111001011111a11
01101110111110111101011011111111111111110111100011111011111111101111010101111111a1101111222212121201122212012201000211111111100111111111110101101111101111110a10
01110101111111110111111111110011111111110010011111111110101111111111111010111111a1011001122212001001222002122221012110110111010111111001110111101101011001110a10
11111101111111011111111111111111110111011111111111011111011111111001101111011111a1011110222122100001221110212112020102111111011110110101110100111111111111111a10
10110111101111111011111101111101101111100110111111111110111111111110100111110101a1111111220201111112111121221120102010111100111111111111111111111011110111111a10
11111111111011111011011111111111110111111111111011011111101111111111101101111111a0011010212211001210221112102111001012011101111110100111000111111111110110111a11
11111111100111111111111010111110111111011101111110110111111111010101111111111111a1110112112212222102110021220112012100111101111111111111000010111111111111111a11
10111111001011101111001111111111111101111111111111100011010101111110111101010111a1011101011111111011110111001111101111101011011111111111111101000111110111111a01
00011110111111111111111111111111101110100111101101110101110111101111001111011111a1111000111110111111011111101111111111111111111011011111111111111111111010011a11
10111111011101111111111011111110110111011111111111000110111111111111011111101101a1011001011111111111010111111111101111111111111111111111111011111111011101111a11
11111110110111111100111011111110110111111111101110101111011001101011111111100111a0111111111111111001110101111111100011111111010101111111111110111100101101111a11
11111010111111111101101111110110110111101111111011111111111111111001011111110111a1111001111111011111010111101111111110111101111111111110111011111111111111011a11
00111111111110110111111111111111111111111111101001111111111101111101010111001101a0111101111111111111111110101111000011101111011011011111111111111111110111111a10
00110111111101111101111110111111010111111110111110111111111111111001111111011111a1111111110111111111111011111111111111101110011111111110110000111110110111011a10
11111110111111111111111001011010011111111011010111101111111111111101111111111001a1101110110111111010010100111111111011111111100111111110111111100011111111111a11