144 41
11 45
35 24
71 99
39 98
98 33
54 73
31 30
21 50
101 72
1111110a1011111011101111010111110111101110011111101111101111111011101111101111101110111111011111111110111111111111011011111111111111111111111100111a111111010011
1111111a1111101111101101111011101111101111111011110111111111111111111111011111111110111011110111010101101000110111110111011011111101111111111111000a111111101010
1111111a1110111001111111111111110111111111111110111110110111101111110101101111111101010111100111111011000111111111101110100101111111111111011011111a110111111111
0111110a1111011111111010111101101111010111111111110101111111111111111001111011111010111111101110011101110110111111110111111001111111001111110110101a101101111001
0101111a1111111100110111110111111000111110110111011010101111111111111111111010111110111111110110001111111111001101111011011011111111111111111110111a010111111011
1111101a1111111111011001100101111111111111101111011111011011101010111011111111001110111111111110011100001111111111110110001101110111110110101111110a111001111111
1111111a1111111101111010110111011111111101101101101111101011011110111110101111100111101101101010101101111111111111101100111111111110010111011011011a111111111011
1010110a1011110101111111011101111101111001000110011111111011110110011111111101110011101111111011111100101101111101111111010011111111111111111011100a100111111111
1001110a1111111100111111111001111110011101111101011110111111011111111011111110111110110101101110101111111111111010111111111110111101111110111100110a111111111111
0101110a1111111110111212020222120111111112222112210111011111110101101111111111111011010111111111101111000111110111011111011111111110111111111110101a111111111011
1110110a1111101111112202121220211110212212100120202111011100111001111011111111110101101111111111111111110101011111111111111111111110111011111111111a011111110110
0111111a1111110111111220111212010110212111121122021111010101111101011101111110111110011111110111100100111111111111111111111111101110111111011111001a110101101011
1101100a1011010010112202111101211121221220222122100111110111000000111111001001110111111111101111111111111111110111110111011001111001111111011111111a111110111111
1011111a0101111111010100001211111210121222112111222111111101110111111011011111110111110011111111101111010111101110111111111100111111011111101110101a111011111111
1011111a1111111111112010121212011222012202211211221011111111011110011111110011111011100011111101101101111001111111111110010111111000011101101111111a110111111011
0111101a1100010112102202122111222201122202221210121111111011110111111101111111111111111011111010010111111111111111111011110111011111101101010101111a101110111111
1111111a1011111111112221202202121222222210001220202111111111101111110111101000111111111100111110111111111111110111101101111111011101101111111110111a111111001111
1010111a1011101020222212222112212002120222121122222111111011011011111110111101110111111101111101111111001111111011111101110111111010011111111110111a011011111101
1100011a0001111021211122222222222200220022202221011111111111101110011001111111010110111210021122211221121111221202110111111111111110111010110010110a110110100101
1111111a0110011110122222221202202122221202120112111111111011111111111011110010110110221221202212221222202100121221111110111101111111111101111110101a011111101010
1111110aaaaaaaaababbbbaabbbbbababbbbbabbbbbabaaabaaaaaaaaaaaaaaaaaaaaaaaaaaaaaaaaaabbbba21221211001122112002112000111110111101111101111101110111111a111111111110
111110101111011121122222222200220220020022112011210111101111111111011111011110011102112b22121211212112121011112212111111111101111111111111111110111a111111110110
111111111111111101212212120021002212112010022012222111111111111111110111010000110112121b11121100211201222022220111010011011001111110111111110111111a111100110101
111101101111111101102202222211222020202222202222202111111100111101111101111101111110100b02122021220111201100102102111111111111100101101011111110110a111111111111
110111111111101102211212212122102221120202002211100110011101111011111111111111111112110b22211222012102221012222120111111111011111101010111011011111a111001101111
011101101011110022121211000201200012122022212221012101111111011011101111111101011110122b12121110021122102220112120111011111111111111011111011111011a111111111111
111001111111111112122220022222202022022222222012122111111111111111111101111111110111122b11121112111122211001120201110111010001101111111111011011111a111110111111
001111101111111122012212022222020211222201020122220111111111111111111101000111111110222b11201120211212111111202211101011111111101011111101111110111a111011101010
101011111111111102220221212022220110221220122220111011111111010111111011111101111112022a10111121212010120102111112011111111111011111111101110011111a111111111011
101101111111011101222122220022202222121110222001011111111111111111111010111110111112110a11110110120121210022111100111111100001111111111101101111101a110111111101
110111111111011112022222112201010210211220122221212111111111111101111111111101111101222a11112211212022211221100101110111101111101001001011111101111a111011011111
111111111000001101112211201221222202220202122221021111101111110011111111111111001112122b22211010022121112202221212111111111111111011101011111111111a101111111010
110011111111110122120110022211002120102220220122202101011011011101010110011111101112201a22202221201111120121021121011111111010110011111111110111011a111111010111
011011110011111121022002102012012222020210021221011110110111011111111110010111111112210a22121122111012121021211221111110111101101110110111001111111a111101011111
111011111111011122212211222212210212102212221221210101111110111111111111111111111112222b22121112011012111221010220001111110111111111111111111011110a011111111111
011011001112011222102022212210221222212220211012102111010111111111011111111101110111211a20021220121101122102211220111111010111101110111101111011110a110110111111
111011202222012212201221222222222220212200222001002111111111110100011110011111101100000a12221112211111221002212121111110111111011111111111111101111a110101111111
111111211210121022222022022222222020202200220221101111111011111111111011011111101112021b21022011122011020020000111111111110011111101101111110111110a101011011111
011110002110222202212220221202112222222222220202211101011100111011011111011111111111211a11222001120121021202201112110111111110110011111101101001101a110110110111
111111122212122022220122002202022222221101122021012111011011011111111111111111111111211b11211022122020211122121200111111111101111010011111011010010a111111111101
111111102020101222222102120200222002221120221101011111100100111101001111101111111112221bababababaaababbaababbbbbaaaaaaaaaaaaaaaaaaaaaaaaaaaaaaaaaaaa111111101001
1111011121021001222121022202210222212101222021111111110101101101111101111111111011102222102122111020112211112222121111011111111111101101111110111101111101101111
1111111112210120222221212102201122100201211212111111111111101111110110011111111011112122211122122112112012122202101111111111011111110111110111111011111011101111
1101112112112020211222201022220221222012122101111111010111111111111101111110101111120211111212012121221221211112221101001110011111101110110111111111111111100011
0101112121010102210222212222021212222212112211010111011001111101101111011111111101121112211111211212111120120201001110111111111001001110111111001111111110111111
1101111022021212110221222202211222200220220221011010111111001111111001010101110011122221020121211222111202201111001111111111010111110111101111010011110111111101
1111002112121021012111101101122212221101011110110010101110111100100111101011100011102021122202100121222201002200021111111011100110111011010111111111111111011011
1101011210221112120221121212112111111111110011111111111011110011111111101111111101101102022011101202121120111110221111111111111111110011111011111111111110111111
1111111222200201021111102101111122222111111111101111111111111101111111001011110101111220211122110112102222111101111101101110111111111110011111001110111111111111
0011112111102112021221110110212102122100011110011110111110100111011111111111101111111111101111110111111011111111011110111110001111111111111110011011101110111111
1011112101111211112122020202221212020111110100111110101110111111100111011011101111101111011101011111110111111110101111111101101011111111111100111101011111011111
1111111112220220102121212111121221211110011111011111011101111111111100111111111101010101111001110111111111110111101111110101111111111110111111110011011101111111
1101110121201212210002121112112111121100111110011111110101101111111111101101110011110111110011100111111111111111111111010111111111110011000111110111011111111111
01111010202022022120121211101222121111110111111111111011101010111011111000101111aaaaaaaaaaaaaaaaaaaaaaaaaaaaaaaaaaaaaaaaaaaaaaaaaaaaaaaaaaaaaaaaaaaaaaaaaaaaaaaa
11101122021102121221120211012201102101011111111101111101101111111101111111011111a1111101111101111111110111110101101011111110111111011011111001111011111111111111
10011121222021211200022211122002201021101101101111111110110101111111011110011101a1111111111111101110101011111111110001011111111011111111111110111111011111111111
11111111110222121201012111122021211120111111111110001111111010001111011111110111a0011011011111111110101011111111110111101111101111010111011011100111101111111111
10011111122111011211121221211112100211111011111111111111111111101111101111111010a0111101211101122121120222011222110211001101011101111110111001101111011111111011
01111112212020112022122212122021202121121021212122212212111102201122221111011111a1010000220022122100212012012112211101101101011100011101111011110111011110111111
11111110022120110220121200112121210121011121202121121122121212122022101111111101a1111111020001112021020020111210011101011110011111111111110111101011111000101001
11111002012102112211101020201201212101122202211222121220212221222111111110111110a1111112122110001222201200012211220211110111111111111011111111111111111111011111
11111022212111122212101112222212021111122111222211212222202022221112211101111101a0101122012122022222020221202021120211110111101101111111111111101111101110111011
11111102221002222011122101110002221221121220212210110111220212211001121111111111a1010002211222002201002221222212210111111010011110111111101111111111111011110111
10111121222012200212220201210112122110112211201222221212222102211121011110011101a1111001221122212211121012002212111021101011011110110111110111110111111101111111
11011111202022101010111121222112121220122212111222112102022122212202101111111111a1111021202221211122212221102121221111111111111111011110101101111111101111111111
10111122211122222220212222022202012211102112121220121021112120021102201011110101a1111022022222211021112211012022201101111111110111110111011111111111110111111111
01110111101010110101110011011011111110122110122212122102110122000100121011110110a1110120012122211121022011121221122221111101011110111111111111111101111010101111
11111101101111111111111110111111001111112121211020111212202021112102111110111101a1111102212222120101121220201120211211111111011111111101110111111111110111111101
01111111110101111101111111011001100011102111112111201210222010011121201111101101a1111112022122122202202121011221112001111011111111111110111111111111111011110011
11111111111111111101111011111110111111110221122120201211122021110122011111011111a1111112220210212220210120210001212101111011011111111101101111110111011111010010
11111111100111111100111011101111001010111202202121212111122101111201121111001110a1111122111222002112010020220212102111111111110111111111111111111111111111111100
11110011100011111001101111101110010111002212021212122022220122110111221111011111a1111020011101020021011222111212121221111110011011111111111111110111001110111111
11111101110101111111101101101111111111122122201200211210121012121112200111000111a0011122220201212200112210112211122200110011111111111101101110111111111001011110
aaaaaaaaaaaaaaaaaaaaaaaaaaaaaaaaaaaaaaabaabbbaababbbabbabaabbabbbbbaaaaaaaaaaaaaa1110022121212211222112112212212111211111001011001010111111111011111101111011111
1111011111111111111111110111110111101111221021111202221122211020221001111111111011110122122220212020221112221012201021111111111111111110011101110110111111101111
1110111111111011101010111110111101111102212222221112201011222111021112111100111111111101101222121212221212220102202211111011111111111111111011111111011101111111
1111111111110111110111110101111111111111122120221122101012212111211222110111111001111020112022211012101220021221120221100001000111111111011011101111011111111111
1111101101111111111011011111111101111110011101112102221212102211222201110011100011111111222201102111111201111112111101110011111100101111111111111111111111111110
0110111011111111011111111011111111101110021012212201110221102022121221111111111001111112010121121122122211011212111211101101111111011111001111111111110110011111
110111101aaaaaaaaaaaaaaaaaaaaa0111001102112202110001220120222200120202011111111011111022121022122012200112221211221111100010011110111111111110111110111111011111
111110111a0111111110111011111a1110100111220112121121201112122010222221111111111aaaaaaaaabababbabaababbaabbbbbbabbaaaaaaaaaaaaaaaaaaaaaaaaaaaaaaaaaaaaaaaaaaaaaaa
111111100a1110101101111111111a0111011111211212210202220211212202002001101111110a1111112111121121002222111212111222222111101100111111111101110011111011111011111a
111101101a1011111111111011110a1111011012001002101122201201110212100121110111111a1111112211121020000222112101002120120111111111101111111111111111111110111001110a
101110111a1110111110110121222b0011012212220022022202212022111121220111101111111a1111112222012210002112122102212000211011111111111111111111111111011110111001111a
001011011a1101110111111110210a0122012110222110212002202010212220222122101112221b2201221212211221221011101112112221112111100111111001101111111111000110111111111a
111101101a1111111110111111211a1002211212220222202221022222222202202102222112120a2012222022201221122111212102021110222110010011110101011111111001010011010101111a
111011101a1111011111111000011a1111200112222222222222012122222122210202210201220b1010121202110110211021100210221222120001010111011101111110111111110111111111001a
110110101a1011110100110112220a1010222112121022220221212122012122222201221120101a2012222021122122222212211212111222201110111111011111111111010111111111101111111a
111111101a1011110111101111222b1222112220222010212000222110201220211210200121120b0221111000110111110111111110101111110111111110101110111011111111101101111111101a
111011111a1111111111000121200a2001200011022221221210210012210211211222222011222a0220121111111111111101111111101001111110011011011010011110111010111111110101110a
101111111a1011110111111120011b1120012022122202120020111010002202222110212210212a2221110100111111011101110111111111111111111101111100100111111011001111111110101a
111111111a1111111111010120121a2200121211122220112022222020121110111212222220212a1212222011101111110110011110110011110111111111111011111111111001111011111011111a
111111010a1111111110111110112a1102111021221212120121112121210012021122112122201b2101021111101111111111011111110011111011111000111010101111110111111011011111111a
001111101a1111111011111121201a2121122022112011202112100122121221122221102222002a1211220111111011111001111111111101110111110111010111101110111110111111111110111a
111111101a1111111011101111102a2111112112222020221202211002002122012112111012212a2222212111110101110111111101111111001000111011111101110111111111101111111110011a
101111101a0110101111001102102a1210001102111122001020010002121111011212020111102b1212210111111111100101011110011011110101111011111111111111011111101111111101000a
110111101a1001111110011111222a0021012122212111111112011112111211002212122011102b1202120111101111111111111111011111111111100111111111110111111101101111111100111a
111110011a1100111110111122021a1222220112222012122212221111010002102012201121122b1222122111010111111111111111100101111111010111100111111111011110100001111111110a
101010111a1011001110011112221a2222100022211122020122010122021100011202011211102b0102021111011111111111111010111111111101110110110111111111101111111111110111101a
110111110a1111101101111102202a2221001222202002112011121120121122200012112222200a1111012011011111101011111011111111110111111111111111111011011011110011011101101a
111111011a1111111111110122100b1012001111112221112102110120110220221101110122122b2111020111110111110011100011111100111001111111100111101110111110100111011011101a
111111111a1111110011111111022a2011201120112211111221122111120222110102212222122a12112121111111100111111000111011101111111110110111011101111111100111111111111110
110110111a1110111110111122221a1211210211111211111200111121202011022121212022202b00211020111111111111011111110111111011100110111111110011111110111111101111111101
011110100a1011101111111121221b2122200202102202212121211120120121220121001222212a11111001111110101011011111111111110100111011111011111011110111111111111111111101
010111111a1111100111111101010b0101211101211122111121201121222202021221221011121b22111121111111011111111111011111111111111101111101101111110011111111111111111111
111111111a1010111111110102122a2122210110110201112101220120211110202112222212211b22010221111111111111111100101111101101111111101011111111111110101111111101111111
011111111a1110011111111111121b1021121112221112120010100121021221111121102101221a21211021011011011011011011110111101111111101111010111111010110101100101111110110
111011111a1111111111111112202b2112111212212211212012121122222202101021200021220a10121121011111101001110100101100101011101111011111111111111111111111011111011101
101111100a1011111011111021121b1122122101100212102021121112210120101001222222211a21111111111110101111111111110010111111100111111111011111100111101111001111101110
011111111a1111111111111102222a2101001111120211111120221122220112221212212201100b11221211111101111011111001110011010111011110110111111110111111111110111101111101
110100011a0111011111110022022a2121020222012212122111000111120211102121111120121b11122121101111110011111011111111111111011010101111111111111111011111100011111101
111101101a1111110111101112011b2202212222122201211221010001111021110111121111011b21101221101111111111011101111111100111111111111111100110111111100111111111111111
101111111a1111011101111121212b2202102110001012222120121121121021122101212120200a21211111101111001111111111111111110111110011101111111111110100111101111111011101
111011111a1111101111111121011a0011112122122202102112221120211112202221121122021b21222111110111101111111010110110110110111111111111111111111111101110111001111111
010111111a0111111111111111111a1011111111111111111111111112212012121221220112222b21121111111010111111101111111101111111111110111101001110111001101101111111111011
111101111a1101111111011110111a1111111110111111111010110111111111111111111111111a01111111111111011111110001011111111111000111110110110111110110111111101101101111
010111110a1111110111111111110a1111111111111011011010110110111111011101111111111a10111101101011101111111010111010010110111100110101111010111111111011111011111011
111011100a1100111111111011111a1011110111110001100111110111111111111111011101011a01111101011011111101101011110111111111111110111011110101011111111111101111111111
000111111a1111111011111111100a1111101101111110101111011111111101001111010111111a11111111111111111111111111100111111111101101111111111001111111111111111101101011
010010011a1111110111111111111a0101101110111101111110111111101001101111011111011a11101111101111001111011011111011111111111001111011111010111110110110111110111111