24 113
151 75
53 58
150 23
111 89
24 44
24 4
149 75
89 53
142 40
011101110110120001020121222021220212221210011111111111101111110110111110111111111111111111110111111111010111a11111011101011111111101110a111a11101101111111111111
111110111222210121212121101112122021221211111111111111111111011111111111110011011111101111011111011101110111a01011111111111010111100011a110a10111100101010111110
110111111002202101112201111021120220102001001011111111010101101101101111111111111011111111111111111010111111a01101011111001110111011111a111a00010111111111111110
111111110101212100222122012122011120001011101011110111100010110111101011011111100111111001111110011101111110a01101111101111110111110111a111a01010101111101111111
111010101101121221200012120221212212112111111111111010111111101111111110100111101111101011110111111011111110a10010111111110111111110111a111a10111100011111111111
111111111000211121011100011212221001212101011111111001011111011111111111101111111111111101111110111111111111a01111101110110001111111111a111a10011111111111111111
100111101221002201022120221212211210122201110101111000111111111110111111111111111111101011110101111101111111a11111111111101101110111011a110a10101101111110111011
111011111211101222211220202202221021012101101101110011111111111111101110101111101110111110011111110111111110a11110100011111110111111111a111a01111101101111111110
010100111110102211001201201221120122222201110011011111111111111111101111101101111111110110101111011111101010a01111101111111111111111111a212a12111012221122122210
100011111111011122112011012011121222111201011111111101110110110111111111111111111111111111111111111111111111a01111101011101011110011110b222b11211111121200122220
011111111111212110211211121001122112220111111111111111111111101011111111111110111111111111011111111101011100a01111110001111011111111111b011a11012002222212212122
111101111220120212022002202101212011112211101111101011111111111101111111110111101011111110111111110111111111a11101111111110101111111111a211a10222122121100222220
011110111222122012010122220202022211011111111101101101111111011000101001110111111111111101101111111101111111a11101111111111111110101010a012a22022212210211120020
111101011121111201212122221121011122221111101111111111111111110111111111111111111111111111111111111111111001a11111110111111111111110110b212b02222001201211200101
110111101222211221012212201212100010122211111111111111110111111111110111111101101111111111110111100111101111a11101011111101111111111001b112a21212111021102222011
110010111112121211020200112111212101122110111101111110111101111111011111001011011110011111111111111101110111a11111111111011111111111111b121b21120020012011022212
111110011221120121111210020022102221022011010110011111111011111111110111011111111100111110111111111111111010a11110111011111111100111111b202a22212221112122222202
111011111201112011121212221120222121222111111101111001111101101111111100111011111111111111111101010101101111a10111011111111111111010111b012b01120111222212112221
111001101201120202012210222202222212202111111111101111010111111110111111011011101111011111110111111111011100a01111111111011111111111111b122b21011101121022111001
111111111202210221201211221200112121101110111011111111111111110101011110111101011111011101011111111110110111a11110111101111111011111111a201a11220111102221012201
aaaaaaaaaaaaaaaaaaaaaaaaaaaaaaaaaaaaaaaaaaaaaaaaaaaaaaaaaaaaaaaaaaaaaaaaaaaaaaaaaaaaaaaaaaaaaaaaaaaaaaaaaaaaa11111011111111111101011111a122b12121212012120022102
101111110110101111111110010100110111011111111011101101001101111111111011111110111111111101011111111111111110011111101011011101111111110b112b12100112021210211002
110101111111110110010111011011111011101001111101111111110010111011111110111111111111110111111111111111111111111011101111000111110111111b011b11101121212112121102
101111101111011111110111111101111111111110111111111111111011011111111101110110011111000111111111011011111110111011111111111110111111111a110a22221122121220221222
010111111111111011111111111111010011111111111111111101101111111110111001101111111011111110101001011111100110100110010101011101111111111a111a01110020002212111122
111100111111111011111100111111010111111111111111111101110111111101111111111011101011111111111111111111111111111011100111011011110111111a202a02022222222112101110
001111111111111111111110011111111001111111111101111110111110110101111111111111111111111111011010111010110111111110011111010111120220121b022a21222121022212220211
111111111111111111000111111111101111101111111111111011011111111110010110111111001100101111111111111111111110110111110111111111112101021b120b12222022120202212212
111101111111111011111111111111010111111111111111111111101110111101101111110111111111111101111110011111100110110111101101111111120020121b202b22222201122122120221
110111111022221110211012120122221001201201111101011111101101111101101111111110111101011011111111111111110111111111111110000110122122112b112b22202212102102022121
110111111110102210002011120121111122222211101011111111011111111111111111001101111111101111111001111111111111101111111111110001111101020a001b21201222122210122220
111011111021112220220011211222212210211101011111111100011111011111011111110011111111111101111111011111101111111110111111010110112001222b222bbbbbbbbbabbbbbbbbaaa
110011111120210001101021201001111212120211011101111110110111111111101111111111100111010111111111111111111111111110111111010110110221211b22121022220122222112212b
001111011121212201011122202021121211102111111111111111111111110111011111111111100001011111111101111111110110101011011111111111111111120b22021022222201202002200a
000111110220011222202120211220202122211101001101111110010011110101111111011111011101011110110101011111101111011011011111111111000012021a02002212220121222021111b
111111110100001111012221111121012221221111101111011101111011011011111111101111100111111011111111101010011100101111111111111101110221222b12121002222210221222022a
101111011002201002222012002102221022210111011001111111111111100010111101111111111001101111100101111001011111111111111110011111111220112b10220120212222202221222a
111110111122120120001221222121120210112011111111110111011110110111110110111101111111111111011011101111011110011111111011011111122221011b22222022222221202222001a
111011111010122202120101122210010211212200111111111111110111110110110111111212222120012001121110021110201000111011111111101111120011122b22201120221002222122110b
101110111022221012221201021222202222102111110111011111111101111111001111111111212112121211000122221111220111111111101101111111112012200b22110221221112021221121a
111110111120202100202111212211220002121110111011111111001110111111111011112221110012021202222222021010022110110101111111111111112101100a10021212201202122121221a
011111111012110120211021100221202222211011111111111101111101101111111101102202202210122110111120222121210011101111011101111100111011122b21201022110222121222121a
100111101211022201111210202011001211112211111101111001011101011111111100111001212001011011012110022221101110111011111111001111102112211b22111120020122112111121a
111011001122221210122021110220012102201110222021101122201120211112221111110101111112110212011212011211201111101011101111001111011112211a20202100101111121120121a
111011111121221122220211112202211210122222222102220220220011202111201111112122122111201202011112201212020111101001110110111011111220212a22101222122121111211121a
111101010111222112121011021022101112222202121022212212220122211221220111111011102020212021100220222022120100111111011111101011122221111a22011122201120221211211a
111110100202120121100121010220212210122021201120221122121221222222201111112222201211111020002020021102111111010011111111001111121011222b21212210112211012221101a
011110111222021112220212001110212201022222222110121221211222121222011101012011012121202110211222120022210111111101111110101011101222101a12112111112021222221100a
011111111101110111120111222111222022122221202122021111221110102111011101111222212222121121102122012202222111111100111101111111121220101b01100211202221100101220a
110110101222211121121222200122122220000001110121221111212222021221002011111001121211111111111022221201212111011111111111111111121210110a01212021121221112122120a
111111011101021210012202121010202201122222221110110202020120000012122111111112211122102100111201020101200110011111111111011110112111111a12122211121120012210110a
011011111101001101121210122111021221002122022122022012201111112121011111112121110222122101101011122020011111010111001111110111120021122b01120201221002122202111a
011110101012022012111121121010221112202211220212121121120222001111202011101212002221212011112112212022122111000111111111011111012112011a02122122212022211111221a
111011111201112010202122222021112122122222002120112022210101111110020011110122102122120120211121212112001111011111111111111111112122012b22211112212010121202010a
111111111121120211110112122222120121012202120211210101222111222222022110110110120020121111111121101111121010111111111010110110101012112b10222121221111211021011a
111101011200212122110221211120112011222111211101011120221212121210102011112221102021210200222000112111120111011110111111111011111001122a12211022221102112212211a
111111101210022122222021002110122001202121122221111111010102211122210111102021021022012001221220012021112111110111111111111111011110111a10010101111111110111011a
111111111200221021211212100221211121012012110221012122211111112222121111100220222121122210112220222202221011111110111111111111111100111a11111010111111111111111a
111111101121020211121222011220112110212202111222022200221222211022002111011212111212220012120011220022022101011111111001111101111110011a10111110111101111111110a
111111011111120112002100001120212112021221211011121222210021100111212001111111222202202012112012012012121101111110111111110111101010111a11111101010101110111111a
110111111110111111011001010111111110101202112100201111122221212212201101011120212212122121112122122011212111101111111001011100101111111a12002121011121111111112b
111011111110111101111111111110110111111011121210122121112212122221202110112012010212112012012101202222222111011111111110011111111101012b10202021112020010211212a
100111111111111111101101101110011111110121121121111012211111221202212111111220122102212201220212121211011111111110011001111110111101110a11112121220220000011222a
111111111110101111001111100111111011111220111111010112210210011212011101111112111212202220110211012111002111110111001111111011110101011a12222100002101011221222a
001100111011011101111111111111101110100222022211212221102112221222112111111100202002122012211121121220002101111111111001111110111111011a12211101222110221122111b
111111111111110110111111111111111011111022202201002112022110201012212111102101102121211111022122202220112110111111101111111101111111110b20112101101212201212021a
110111111111111111111111111111101101111222122201212221021011122011211111112020001121111011121222112221210011111111111011111111001100112a20211022121120221212122a
111111101111111111111111111110111011111222010220020022221121020121121010111120011210201011121211021200122100111111101110111000101111112a20212120221012121221110b
aaaaaaaaaaaaaaaaaaaaa001101111111111112111121102111211111010222210211110111112110212100021112101222212121011101100111011111111111111012a21002110020221222221211a
00100111111111011111a111100111111111111220102211112111201112200201002110011110111111111110110101111111111111001111101111111101011111110a21111112121121112110210b
01110111111111110111a111111111111010112221102102111101122111222102221111011101111111111111010011011011111111011111110111111111110100110b11120220221121222112222b
00110111111111110101a101101101100111011022212102101210010222110021122110111000101111111110111101111111110111111111111110011111101111112b21111222110211222112120a
00111111111110011111a011111111111111011221010102211110120120210211211011111111100010111111111111111110111010111111111100010011111011011a00211222111211121221202b
11111111111111111111a111111110111111101120111222201220202122222120110111111110101110010111111101111011011111111111111101110111110011111b12122001021102012221112a
00111111110101010111a101110011011111111101111001111111010001111110111110111011111111111011111111100212220200102221211121212200111110102b20102022111011111222110b
10000111111111111111a100101111111111111111101001101101111111111111111101111100100011011111111111222001101122012222101111211112101011112b12210212101201212122122b
11001110111111111111a010011101111111111111111111100110111111111111111111111111101110010101111101102102221221220122111202121122211110112a01122122200101121221201b
11111111111111111110a011101011110000110001111110010111111111111100110111001101111100110111101011212221121102122200211202020101110010112b22222121220022011001121a
11100101111111111110a010111110111011111011111111110111111111111101111111110111011111011111110111122020222221022210111121012120211111011a11120102122022110222122a
11111110011110101011a010110110111111001111111111111110111101110111101110101010111101111111011110022011010110122101222111211122211011112b20121212221212212211112b
11111111111100111111a111011011011111111111110110001111011110111011101010010011111111101101011100121221011101110211222012001211211111112a21220122122212211002211a
11111111100111111110a100101110011001100111101111111011111101011011111011101111111110111111111011111122010020101221012121210222210111011a11112002111201102221222b
11111111110111100101a111111110100111101111111111111111111011111111111101111101111111110111111000112020222211122202202202021221211111001b12112121121102212110021a
11111111111100111011a111111111101111111110111111111111111111111111001111111110111111111001111111212222222201021101222222022122111111110b02121122121121101120120b
11111110011011111111a111111001011110111111111011011111011111011110111111111111110111111101011111120112210221121001202110102211211110102b00210121021010212022211a
11101111110011101010a010101010111111000111101011111111101111111010011111111101111111011100110111110111211112121021121112012121111111102a22102212101111021012111b
11111111011111101101a111111000111111101111111001011110111011110011111111011111011011110111111110111122212212211112201112012022110101112a00010101112012121221121a
11111001111110111111a111111111111111111111111110111101111110111101110111111111110101111111110010211211101212222201121222011121211111010a21201121220211210121222b
01001101111100011111a111101101111111111111011111111101011111010111111110110111111101111011110111012011121111111200002210222211010111011b11220121112112212221112a
11101011101111000110a111111111101101101011111111111011111111100010111111111111111111011010111111212221212112202120022202112212210101101a11201220102202122102011b
11001111011111011101a100011011111111010000110110101111111111001011110111111110111111111111100111212221111200221102212101111211011111112b11122201202001122212121a
11110111111110111111a001111011101101110011011111111111110010101101011111111110111111101111111011210102211120222211021212221122111111111a11011111111011101010111a
11010101111011111111a011101111011011111111011110011110011111101111111111111111111111111111011110222211122112120122222010022212211111111a111111111111010111101010
10101111111111111111a101111111111101111111111101101111101111110111100111010111111111111111111111020201022112111201121202112100101111111a111110111110111101111011
11111111110101011011a111111111111111011110011111111111110111110110110111111011111110011111111101101222211100111112122211112121111101111a111111110111111011111011
11110101111110011111a111111111111111110101011111111111111111111111100111111110101010110001111101202221221201110120121222122220011111111a011111111111100110011000
11111101011111010011a011110101010101101111111101111101111111111111101111110111111111111011111111222221112112011021011000011202111101011a011110101111100111110111
11111101111011110100a101011111110111011111111111011011111111111101011110001010101111111111111100221121221112221011021021112121211110111a011011011100110011111110
10101101110111101111a110111111011111110111110111111011001111101101111111111111011011111111001111221202212102201222121101001121211101111a111111111010001111111111
11111111011111111111a101111111111111011111111101101010011111011101111101101011111111011110111110221110110220120011120210221021110101111a111010011111111111011111
11110111111111111101a001110110111111111111101000111111011111111011010111111111101110111100111010011222122222001011121212112102111111111a011101111010101101111011
11110011111100111111a110101000111111010111111110111101011010110111101011001100110111101111110101111001210122011102021112110211211101111a111111110111101111011111
10111011101111011001a111111101011110101111111111010001110111101111011111111111111110111110111111102100202211101210212210211211111111111a011110111111101111111111
11111110111111100101a111111111101111111111101110111111011110111101111111011011101111001111111100111222221112012112111212002121211111100a111110110110011101111011
11111111111111111111a111111111110111111111111111111111011111111101111011111111111111111111111111111100112121211211111111211112010110011a111011111111110101011111
11111111111101101111a111111111101011111110101111011111101111100111111111100110111111111100100111111011101111110110101010111111111111111a101111111101101111110111
10010111100011110110a111011011110111101110010101111011111110111110111111111111011111101101011111001011110110101111011100011011111111111a111010110110100010010111
01111101111111001111a110111101111110111110111111101001111111111101110111111111110111110111101011111101111101101111111001101011111111011a110111110101011101100101
11011110111111111110aaaaaaaaaaaaaaaaaaaaaaaaaaaaaaaaaaaaaaaaaaaaaaaaaaaaaaaaaaaaaaaaaaaaaaaaaaaaaaaaaaaaaaaaaaaaaaaaaaaaa11110111111111a111110111111111111011111
010111101111111111111101101011111100111000110111111111111111110111111111101111111111101010111111101011110101011111111111a01111111110011a110111011101111110010101
111101110110111111111111111111111111110101111101111111111111110111111011101111111111011111111101011111111101110101111111a01100111110101a111011110110111111111111
111111101111001101111111110111111111101011111111110011111011111110110111111101111010101011111111111111111011110111111111a11010101111011a100111011111101111111101
111111101110111110101011111111111111110101111110010111110111110110111101111011011110011101011111101111101011111110011111a01001111000111a111111111001110111011011
111111010110111111111111111111111111111111111111111111101111110011111111111110011111111101110010111111111111110111111101a10111101011111a111111111111111111110111
111110011111011111111111001011101101111110110111011100110011111111101001111110111111111111011101111011111110111101110011a11110111101110a111101111011111011111010
100011111111110111000001111100111111111101110101111111111111111111111111111111111011110101110111111111111101000110011111a11111111011011a111110111110111111011111
011011001011111101011110111111011101111111110111110010110111001101110110100110111100101011110111111011011011111110111111a10111011111111a111111111111111111111111
111101111111111111111101110101111111011111111110111111100111111111111011111110011111110111111111111111111111111011011010a11111111110111a010111100100111011111110
110111111011111111111110111111011111111110111111000111101100100001001111111110110111111111101111101000111011110011011000a11111111111111a111111101011101110111111
110111111110111111110111011100101111000011110101101001111111111111111111101111111110011111111100111101101111111111111111a00111111101111a111111110111101011001011