143 33
45 106
55 30
116 99
91 46
139 65
57 116
24 108
17 17
87 57
10111110111111111111111000111101111110011111011111a0011111111a10110111111111001a11101011111001111110111011111111101100110110111101111001011111110111111111111011
11111101111111111111101011011111011111001101110111a1011101111a11111101111110111a11110101111111011111111110111110111100111001100111101111011111111111111101111111
11000120011111000011202211020221111010011001111110a1110111111a11101110101111111a11101101111111101101110101001111110011111001011011111111011111111011011101110011
01112112222221120221220001120212101111111101111110a1011111111a11110110111111111aaaaaaaaaaaaaaaaaaaaaaaaaaaaaaaaaaaaaaaaaaaaaaaaaaaaaaaaaaaaaaaaaaaaaaaaaaaaaaaaa
11211101202111101121212200212210111111111001110111a1111110111a1111111010111011111111110111010111110101111111110100111100111100111101111110111111111111011111111a
11002111122001020120022202021122201111011110111101a1101111110a1111011010100111110010111111101110110111111011011111111111111001111101111011101111111011111011111a
11212021221202212110122021122021211111111111011111a1111111111a1111111111111101011011001011111011011111111111110001111001111111110111111001111111111111111111111a
11200212222022211200110220111121011111111111110110a0110111110a0111111111101011011111111111011110011100111111111101111011101111011111111010011111101101001111111a
01112120011122021120212112202211211111111011011111a1111111111a1111110111101111111110111111111111001110101111110111111101111110111111111011101110111011110111111a
01022222220121212012110221120220111111110111101111a0001110111a1010011110100111111101111011111001110100101111111111111101111111111111111111111000011110111001111a
01121211022220122122221012002112211111111101110010a0101111011a1111111101101111111011011111111111111111111001111111111101001111011011010001110001111011110111111a
01021220221221212220002211022210211110111011111101a1110011110a1111111011100111111101111110110111111111110011111111111101111111111111111011101011101111101110110a
11121201212101002021221101220220210101101101001110a1111011111a0111111111011111111111111111111110111001111111111101001111111111101110011110101111001111111111111a
11122001121102011111212101211012211111111101111110a0111101111a1101011111111110111111001111110111110111111110111101010111001111111011011110110011111001101011111a
11221222221222122220112011201112111111111111111111a0010011111a1110110110111111111111011111111111111111101101111011111111110111011100110111110111111111001001011a
01101122211222100222110101011112011111110202122122a1122111220b1012212101111010101011111111111110111010111011101110111111111111111101111111111110111011011000110a
11111101101222222102221120120211111111011110121212a1012201111b2200011011110111111110111110010011111111111101111111111111111101110101011101111101111110110111111a
10120120220221202211111211210201011010110200021122b0111221222a2221221221111111111111111111011111101101111111111101111011111001111111110011110111111011011111101a
00211022210100220111122222212101111111111222222102b1002120220a1120112221011010101101111001111111011111111111101111111111111111110111111011111011111111111100111a
11002101201122112221221120112221211111112112001221a2221212212a1121022211111010101110111101101111111111100111101111110011001010101101111111111111110110111111111a
11221112200221202110100221102212001111112012121112a2200111212baabbbabbaaaaaaaaaaaaaaaaaaaaaaaaaaaaaaaaaaaaaaaaaaaaaaaaaaaa1101111111111111111011110011011111111a
01121122012221212110210111121112100011010011222220b1020221210120200120111100011111111110111111000110101111111111011111111a1110111101011111110101111001111110111a
10221102122120212210112202212211011111111220221222b2220210121101211110001110111111111111111111101111111111110111111011111a1111111111010111101111111111000111111a
11111102201220201101120101012121201110112221002011b2112121022221002121101111111111101111111011111111100111111111011111111a1111110111111101101101101100111111110a
aaabaaababbbbabbaabab21111202101110111111210202120b1121122102202112111210111111111111111110011111111101111001110011001111a11101111111111101101111101111111111111
11120111020212101011b01102102121110011100201210221b2102220210112120101111001111110011101001101111111111111111111111111111a11111110111111111111000111011111111010
11221121102221222002a21021122122211111100021110021b2202111112212211212011111011110111111111111101111111101011111110111111a11111111111101111111111101011100111111
01112110112022222010b12100111022111011112111221022b1212221011211111121211011111111111111110110111011000111101111111000111a01111111001000011101110111111111111111
11110212222120221111a11222022201211111111120222201b1122112110211212011101110011110101101111011011111101001111101111110111a10111111011111111111111110111111111111
01202212022112121221a21111111222211111001002220211b1002022022202121122211111110111111111111110101111111111011111111001111a11111111100111111101001101111111111111
11202220001210121212a21220222120211111110122002120a2222121000202211122211011111011011111001101101111011101111111001101111a00101111111111101111010101111101111101
11111212112111211222a12212122021211101012212221211b1111100020201211221211111020012110102211202221221011220110111111111111a11111111111101011111111011110111110010
11122010110011212221a22012101210210111111111211112b0101211122021111200100111100200211222122110012220022022211101000111101a10111111101110111111011111111011011111
11010001011111000111a11011111101111101112211221121a1102212220212222222211111101220210222012111012120211212011101111111011a10111111111001111100110111111110110111
11011011011101111111a11101101111101111012212210120b2111120212212210012111101221111222111221012012211020210111101011011111a11110011111111111111111111111100111110
11111110111111111101a01111111111111111111120011012a2221221202211221212211111021101121012112122111101212010010111110101111a11101001111110111011111111111111111101
11111111110111111011a11111101111111111110011222012b1220012121122212111101111202021211102102102121112211212201101010011111a01111000100111111101011101111111011111
11111101111101111111a11101111011111001111122011200b1102121211121111002011111112112122122012111112211211122101111111111011a01111110111010100111110111110101000111
11111111111101111100a11011111111111111112222201112b2212011201212121122101111122010121121001021012022112111211111111011111a11110011111101111011101101111101100111
10111111111111100111a11111101111111111111212112222b1101111222022001221111111212222102211212212112112202011211111011101111a11111111101101111111111111111101111111
11111110111101111011a10111011101111111110122211020abaabbbabbaabaabaaaabaaaaaaaabbbbabaaabab200122112222212201111001111110aaaaaaaaaaaaaaaaaaaaaaaaaaaaaaaaaaaaaaa
11011101111111110110a011111111001110110021211212120022121011121221121020111102202201012122b210211101100111011111011111111101111011110111011010110111111111111011
11110001111110011101a111110111011110110011221120122012222212011212111211020222021220022222a222112210222111111100011111011110111111111110111011101111111111111111
01111111111110111111a111011111111111111121021120112121220121111122001221222222212122002122b212101222221011001111101101111111101100110111011111111111111111111100
aaaaaaaaaaaaaaaaaaaaa111111011111111111112111202022210020121121121001101100122212222222212b122122222021110111111101111110011111101100111010111100111111100111111
a11011111101110111111010101111011010101112212002111100112122222212202101112222221220222022b202222002121111210111101011011110111111111011011110101111111111111011
a11111111111111111110111111110111111110110101011101111111111100111011111122212222222100220a222022222222102211011101101110110111111111111111111101001100101101111
a01111110011001111100111111011101101111111000110110111111001111111011111121002220121212222b222222202221112111101011101111100111001010111111111001111101111011111
a11111111111111111111011011111111110010111110011011111111110111111111111120121222102002220a221021221120020010111111101110110101011111111111111011110100111111111
a11011110110111111101111111110100011100111111110111111011111111111011011122222221220102011b120002222200121201101111111111111111111011101111111111111111101101010
a11110111111001101100110111110101010111111111001111111111101011011111011222110222200220100a012222222101202111011011111111111202112211120001201102222112210110111
a11111111111111100010111111111001111111111110111111001111011111111111111121212021222120112b012122222222210001011010111101111100021202211212120121111220112211111
a01111111011111111111011111011111110101111111111010111111101011110101010020222211222201212b222212210220121111111111011100111021122222201110111021121012222011101
a01111111111111101111111101011111111110001111111101111000111101101101101121122202210202200b220011222222111211111111111111111121022221100022221122012121120101111
a11110111011011011111111111111111011111100101101110100111111111101111111100222221222012020b220021001210022101011111111111111121112021021221122222212011112211101
a10111111111101111111111111111111111001101111101111111111100000101111111221022212211222212b210222120222122211111101101011111112102001112212011222122011201211110
a11011111011101100111111111111110111111101101110011111111111111101111111112220122222220222a202222002212122111111101111011111120112002121022112120112002201211111
a11111111110111111110111111111001101111111111111111111111111111111011111220021212022021222b222221212112120001110101111111011111111122212222212111111000211211110
a11101111111110111011110101111110111111111111111110100110111011111110111202122212212220212a020222122222002110110010111101110112010222121122100022121201011110100
a10101111111111101111111111111111011011111111101111111101110111111011111222222202222210020b020220222200022011110111111111101111101110121211211222111122210111111
a01111111111111111110111111111111101111111111111111110111101111111101111120211221021212222a222202202022202211110111111111111120022111012201212021221112002211111
a10111011111111110111110111111011111111010100101011011111011100111010101210110222201222022b200201221120020101111111111100110201222121202220201102222120002111111
a01111111011110111111111110111111011110111011011010111111101111101111111002212220122221122a002212111112110111011111010111111201020220101220212112222201021201101
a11010111111111110111101111111111111110011011111111110111010110100001101021221211000011212a211021122012111111001111111101111211012211112002022111101022221111111
a11111110101101111100110111110011111111010111111110111011011111111011111111221222121021202a101022202211011010111111111111101222201110011002111101112202102201011
a10111101111110111110111011111011111011011111111110101111000011111111101021112112021122200b012212221122100111111111111001111122021002012002121211121111222211111
a11101101011111001101111111110100001111010011111111111111111111111101110122010222121111122b012012221112111111110111110111111111122101222221111121212211110101111
a11111010011110111111001111110011111111010111111001101101111111110111011102122122122111121a112210112202100111101111101111011202211002011111021211010112120101111
a11111111101111001101101111111110111111111111011111111111011101100101111202121102221122110a022102111101110101111111111110110112202221010011101212222111221111111
a11111011111111111011110101111011001111111110101111111111111101011011111212111111112221212b222021110022111010110111111010111002002221002111112212121111211211111
a11111111011111111111100101111011110111101001011001111110111111101011101222112221120122111b221222111112011111001111011111111110211111122011222220112022122211011
a11011001001110101111001011111110001101101111101111011100110111111110101012222202022110211b202001112012111110111111111110111222221200111100012122122002111111111
a11111111111101101101111011111111101001111111101111010111111111111001101120202221220021211a221112222121111111011101111111011200210202122220022102101212012011101
a11111111101001001111011011010111111101001111111111111111111111101111111111101101011001110a011111110011011101111001111111111221001211121211212011010012112211111
a01111111101111111111111111011111110111111101110100111111000111101010001111111111011111111a011011101111110101111111101101111012100112120222221222122001202111111
a10111111101110111101110111011111100111111111101111101011101111111110101111111000111111111a111011111111001011101011111111011111112112112210121021012221111211101
a11111111011100111111111111111111111111111110011111111111111011111111011101111111010111111a111111111111111001111111111010110121200211122122222222221111211011011
a10111111011111111101111111111111111111111111101111111101111111111011111111111110111111101a011111101001101111101011111001101220122001120211122121121111102011111
a01110011111011101111101110111111110111011110011110101111100011001011111111011011111111111a101111011101011111010100110110111121200201002101011102211221112101010
a11111111101011110111111111111111001111111011110110011111001111111011011111010001111111110a111011111111111111110111011111111122111112021012221212220010022011011
a11101111110011111110011111101110111111111111111011100111111111111111110111101111111101110a001111001110011010011111011111101211202011102001021020222201212201100
a11111011110111111111111111111111011101110101111111111111111101001011111101111111111111110a101100111111110111010110111110111111111101111111101001111111111111111
a11001011101111011111111110111111101111111111011111100011111111011111111111111001001001001a111011001111110111111111111010111111111111111111111111110011111111110
a11010111111110111011101111110111111111101110111111011110111110110111100111111111111111011a111111111111111111111110111111111111010111011101000111110101111110111
a01111111111111111001111111111111111111111010110110110111101111111101110110101110011111101a111011111101112112112212222111111120011210111111110100110000110101110
a11111100111111101011111111110111011011111101100111111101011011011011111111111101101111101a111011001002122111020111112221210021220121101110101111111110101111111
a01101101011111110011111110111111110111111111111111111011111111111110100111111101111111000a111111111022222020111222121222211210101121111101111111111111111111010
a11111110110111111011111110111100011111111100111111111111111111111111000011110111011100111a011101111122200010211221022120022201120211100111111111111110111111111
a01111111111100101011101111111011111111111111111101110100111110010111011111111011111111101a111111011102202020212211112120012001122121111011111111011111011010110
a01111111101110011111111110111111110110111110111110100111110100111111101101101111111011111a111111101110201122201201211100222212011210100111111100011111111111011
a11111110111111111111111110110111011110111011101110010111100111011111111111111111011111111a011111000111212202211121221122112112102120111011111010011111111111111
a10110011111111011111111110111001101011011101111111110110111111111011111111101111011111101a010011110012021221122022222212222112211111101111011111111111111111111
a11111101011010101111101101111111101110111111110011111101011111011111001011111111111101011a010111111012122220022120011122010100222201011101111110111101111111011
a11111111001222210212122012121122222111211111101111010101110101111101011111011011101111111a110011011111222110112011111122021121101201111001110111101011111011110
a11101101201022021001022121122202221121001011111100111111111111111111110111111111101110011a110101111121122011210120101212221222111211011101111011111111111111110
a01011111120112121112102212101112012200211111101111101010011110101111101011011111101111111a111000110111210012222012220221012110121221011111110111100111111111111
a11101011120111221200212222211211222111101111111001111110111111000111111111111101011011111a111011110121201210120122221210221012112111010111101111111111110011011
a10011111012111112201220221011010110122111111101111011111011111111010111111111111111110111a111111011120121110020112012122222012022020111111011111111111001111101
a11111111100121111211111121212202002110111111111011110111111111111101111100111111101111101a011111111112101211220121222210211121211111111111111001101111100011011
a11111111211111202121110102220221212121211111111111111001110011111110101111111111111111101a111111111111212021220210222102211012122001111100101111111111111111111
a11011101222201010111211122112000211001210111111110111111111011011010111111011110101101111a011111011112221212211111102222111212121221011011111111111111111110111
a01111111022111012111212220001221121101111101100011021102022112112121221011011011101011010a111111010111111210212212111212111122202121111111010111111111011011111
a01000110011122121020100112212120202122211220101221112012110221212211212011001111011111101a011001010011222121221022212100012222202211111111110011111110011110111
a11111011021210202021201200221111222201211101110112210202222121121221112111011011100011111a101101111022222122110122212101100212222211010111111111110100111100111
a11001001012212122022212112200112112112111221222121221201222222222000121211111111110110011a110100101012020112211102111010021120222001111011111111110111111111101
a11100101012211211112121221102222211010101022020111110202222021112201020211111111011011111a011111101110121111111211222122212111112211110111011011111111101111111
a11110111222002011122202211222221210210211211212202201111020101221202101211110110110011111a100110111101201121122211221001021102220101101111110101111111110101111
a10101111211222022201212122100111021102111210010221201210200102222210111011111111111111111a111111111000110110222112021211111201111210011111111101111111111111111
a11110101011211211011211121222112022202110012001121101002020010122212212211111111111111111a111101110111110112202122012222221010211120010110110111111111110111111
a01111011222112120222120010112101212111111111002202002202221011211022201011101100101111100a111111101112211222212211112221101222111121111111011111111111111111001
a11111100012122121111112200021202102112211112210201021211010022011121100011110011011111111a111011110122220012222122221001112220012010111111111111111110111111111
a11001111101111222112010202211011120211011122112211021112010102220210112110111111111011101a111111011102111010110111221212210212202121111111111110001111011110110
a11010111012111112112012211122212222122211222002120112200110212212121201010001111111011110a111111110112002112222012012111011202112001111111111111111101110111111
a10111111210021111012211210120120101120111220121211012122220111120000112111101111111100111a101100111120201111011212222201211100102101011011111101111111111111111
a11011111222021201022012212221011010021211021202111202111112211102121202211100010110111011a111111100122121221021221020221221211211201111011110111111001111111111
a10001011202000121212202211022012201221211102112111222200011122211112020211111111111111111a011111111001110011111100111011110111111111111101101111111111111111011
a11111111202110021211102010222210211111111022002122110101022121200121111211111101111111111a001111011111101111101100111101111110101110101111110111101111111110111
a11111101121012120011211221222112101222100122212122010202121111021121220110010111111111111a101110111100111110110111111101111101011111111111111111111111011111101
a10111101222012011111211121201021202120011000222120111211211221112120111001100011101011100a111111111111101111110100111111001111101110111101111111111111011011101
a11101111101111111221212102211101022022211010121021111222111221212202221211101111001111111a111101111111101110111111110111111010111111110011001101011111110100111