72 100
153 3
152 71
105 8
63 47
52 96
141 50
91 107
92 96
55 114
111011111101111010a01111111111111111110101101111011a011110101111011111110011110aaaaaaaaaaabaaabaaabbababbbbbbbabbbbbbbbbbaaaaaaaaaaaaaaaaaaaaaaaaaaaaaaaaaaaaaaa
011010101011111111a11111111111001111111101111111111a11011111111011111111111111111110110011122012201222212210111012122202110111101101111111111111111111111111111a
111111011101111010a10111101001011111110111111111111a00111101111111111111111101100110111111102202222010221111202211022122111011111100111111111111111111111011011a
111111111011111100a11011111111101111111111011111011a01011101111011111110111111111110101011122221101211112101100201121221111011111110111011111111011111001111111a
011111111011100110a00111111010011111111111111111011a11111111111111111111011000111111111111220022112211022212222111110021011111101100011111111101111111110111101a
111101001111101110a11101011011101101111111111111111a01111011101111101111111011111111001111001210111021121202102210120221001100111111111111111101010111101111110a
110011001111101111a10111111111111111111111010001111a00010101111011010111111011111101111111222212021020120221122202111212011111101111111111110101111111111011111a
101111111101110111a10111110111110111011111010010111a11111011001101011111101111111001011111221212101112121221111221121112111110101101111101100111111111111110010a
010101111111110111a11111000111101111111111011111110a01111111011100111010111111100111111111112100121221120222121022100122110011111111011110111111111111111001111a
111011111011011101a11101101011011111111111110110111a11001111110111111111111111011111111111220011211211220121012211221120211001111110101010101011011101101101110a
111110111110111111a11011111111111110110111111111111a11110111011101110111111111111111111111001122212121120221211212202102211101110111111110111111011111110110101a
011111111110111111a10011111111111011111111110001111a01101111111111111110110111111101011111121010021221112112202221112120211101111111011111101111111011111110111a
111111111111111110a11111011111111111110111111100100a11101011111111110111110101111101101111211111221112112110120211212122011010111101111111101011100111100111110a
110111101111110110a11111100010011110101101111111101a01111101101101111111111101100111111111111201121212122102111002111120111110111110111011011111111100111111111a
110101100101011111a11011111111111111111111101111110a01111001101111111111010001010011111111102021111020120120211221121201211111011111011111110111111111111011011a
101100111111111111a10110011110110001111111101111011a11101111110100111111001111100111111111120222220002101201122221222021210011111111110011101111111111111101111a
101111111111111111a10111011101111111110111111111001a01101101111101100111111111111010111011102111010122201011201002121121211111110011111111111111101111111111101a
111111111100111110a11111110001100111111111111101111a11110111111011000101111110111111101100211122221112122212122202111101011101111111010011110111100111111111110a
111011111110101111a01110111111011111111111111110111a10111101011111100011111101111110111111121222020212122011011111201101211011111111110010111100111111011111100a
011010101111111111a11111111011011111011111111011111aaaaaaaaaaaaaaaaaaaaa110110000010011111121212022222122212021212011011111110110011111010111111100101110011111a
011011111110011111a1111111101111111111110101111101111111110111111011111a001111110101011111121021111212201022120110002020201111111111101111111111101111111111111a
111111011011111111a0111111110111101111101110111101110111110101101110111a111010111110111101120202121121101112111221100102201110111111101011111111111111111011110a
101111010111111111a0111111111111111110010110111101110111111111100111111a111111110111111111100122102222121212222222212210210111110111111111111110111110001111111a
111110110111111111a1011011111111111111111111111111111111110011011110111a011110011111111111011011221201021222211122100222200110011111101111111101111101001111111a
111100111100111110a1110110101010111111110111111011111111011011111110110a111111101111111010111001111111111101111111011111110111111100111111011111100110111111101a
101111001011111011a1011111101101101111111110111110101111111111111110101a111111111011011101111111110010011110111111111111010111010111100011111111111110111111111a
111111001110101101a1101111111111111111010111110001111011111111111111111a111111111111111011110111111110011011101111111111111111111111111111111110111101111111111a
111111110111110110a1111111111011111110111111111111111100011101101100111a110101110111110110011010101110110111111011111111010111111101111110011111111011101111011a
111110110111111111a1111011111111011010010111010111101110101111111101111a111100111101111111001101011001111111001011111101111011111110110111111111111111111111101a
100011011110111111a0111111011111101111111111101111001101111111011111001a111111011111111110111111111111111111111111011111111111111111101111101101011111111110111a
111111111011010111a1101101111101101000101111111000110111111011110110010a110111101001101111001010111111101011110011101101011101010111111111111101011111111110111a
111011110111111110a1110001111111111110111011011110101111111111111001011a110111111100111101111111110111101011111111010001111111111011101011111111011101111010111a
111111110101111111a1110111110110111101101111110121102112112211102122110a221110011011110111111111110110111101111111111111001011111101011111011111110111110101111a
111110111111110010a1110101111111111101110101001121011002210212012201011b211021211101101101110111111111111110011011111101111111101110101111101011011101110111100a
011101111111101111a0011110111011111111111111100011122120221111121100011b121101010101011111111011111111111010101111111111101111110010111001110111101111101111111a
111111111111111011a1111100110110001111100111111111121122222102211121210a001202211111111111110101111100101111011111111111011001221202222121022120110120012210110a
101111100111111111a0111101011111111111101011110100111221212010221122212b200111101111101111110111111100011111110011011011111011200011202020121122122122112121211a
101011111111111111a0110111111110111111101000101111110111220112010111111a221022210110111011010101111100111101111111011101111111112121122102021222001101121212211a
111111111111111111a0111001101111111101110111111112122011221212120202121b200212201111111111111010100011111111111111110111111111111012222001011111011121022112110a
101101011111111101a1111111111111111111101011110110202111200202112222111a022012211000110111100011110111111111111110011111011110121022012011202220112211211220211a
100111101011111111a1111011111011111111111111000121210111221112222211112b100211201111010111111111111100111011111111111101111010020020021122021011212122011112100a
011111101111101101a1010101111111001111011111110112111121222202111221112b2022002101111101111010111111111110011101011111111101112111112210122021001202122120111110
011111111111011111a0011111110101101111111011011121011221222221220221110b1101221111011111010010111111101110011011101101111111112012101210111212220112000011121011
111111101111101100a0101111111010111101111111101102021202222111201121222a2122220111001001111110111111111111111110011111101111012011221222112222211220120221211111
101110111001111111a1010111111110111111110111111102211202112110122222211a1211222010011111011101111111111101111110111111100111001221102110000001121212022102220111
011111101111100111a0101111110110111111101111111121121021121220220111022a2222211111101111101111111101111100111110001101101111112121121002201022221221202121121110
001111111111100111a1111101110111111101111111111112200200010010201111212b0112122011011010111111101101111101111111111010111111110101221212111122120101001222021100
011111111111111101a1011111110011001111100111111101222210210011210111212b2222200101111111011011111110111101111111111111110001110210221200121222122121021211111111
011111111101111011a0111111011111111110001111111111122220011220122122201a1121111111101111111110011111111111111101011111110111110122121221111212201202122000212111
111110110101101111a1110101011111011101011111111102200220021220002201202a1202002100111111111110110110110111111011110111111111110101111201122210210222212120110011
110110101010101011a0111111111101111110010111111112202210110201101111020b0201121010011110111111011010111111111100100111100101112122202121112211201112112112221111
111101111111101110a1111111011101111011111111111121222212012201121211222b1002101110111111111111111001111111001111111110011101110120121112111102221211021222011111
101101111111110111a1111011110111111001111111111112101111122110121212021a0102202011111011110111111110111101111101111101011101111201021211202121011121112111222101
101110011011101111a0111111111110110111101111100112222202111112211101211b0211222101111111011110010111110111111101111010111111101101221122102011120211200011210101
111111111111111110a1111100111110001011111011110022112221200222222201122a1202111111100101110111111010111001101110111111111101111202112211110102122221211011121111
111101111101101111a1111011111111111111101111100121201221111000211020110b2122100111010111110111111100111111011111011111111000112101202201121221210111012000011111
101101110111111001a1111111011100111111110110111120120221121221222022211b2111222111111111111111011101111110111011110111011101101110112112221021222001122122222212
111101101001111101a1111111111111110111111111101002111121121012111212212b0111210111110111110010111010000111111011111111110100111220122212122222212022222202110012
101111111101111111a1011111111111111111111110101111011120221020200010212b2122112111111010010111011111011111010111111111111011101222220101022022122222022012112112
011111011111110111a1101011111111011111111110101121122201012001121120120a0221212101111111110011110111111101100111111111111111110211121111021220202201022022222022
111111011111111101a0011111101110111111100111111112101210011222121121110b2221121101111111101111110111011111111011111011111011011221221010221220212220122122220221
111111011110110000a1111101101111111011111111100121101112122212122001122b2112021111111111110111110111001101111111011111110101002101112211222022212122202220200111
111101111011011111a0100111111011101101101011110110110121211221100211112a2212011111011111111111010001111101111111011111111111112222002101210220021210122222222212
101110111101111011a0111111111111111111111111111101110111110000101001111a1111011111110111100011011111111111010111111011111111112211202112222222212221210022222201
011111111110101111a1111111011101111111111111111011001011010111111111111a1011110011111010011111011011111110101010011101011111111101010100211111012022222222221112
111110101111011111a1101111111011111111110011011111111101101111110100111a1111111111110100101111111111111100011111111111110111112221122202222222212211202122122201
111111101111110011a1111011101111101111011111011011011111111111101111101a1111111111111111111101110011101100011110011011011101111011101101121211122211202222112120
111110110011111111a1111110111011011011101110111111111111011111111101111a0111110010111100111110010111110011111111101101111101101000100111110012202102111001101122
010111111111101111a1111111110011101111101101111111111111111111011111111a1111111111011111111111011101110110111011111111111110111011010111101012111112021002122101
011111111010011111a1101111111011111110111101111101111011111111010111111a0001011111101110011111111101110111011101111111111111100111101111112111222211210111112122
111111101011111101a1101111110111111111111111110011111111111110111101101a1111111011110111101011111111111111110111111111101111111110111011101122001210011112002212
111111110101101011a0111111011011100111101111011111111111111111111111111a1111111111101110111111111111111110101111111111111111111111010101112122122102001100111111
101101111111111111a1011001111101111010111111100111101100111101111111111a1111111111011110101101110111110111111111111111111101011111010110022010112112111121102221
110111111111001011a0111111110110010111111110111011101111011111111110111a1011111111111111011011111011110101100110110001111110111101111111102021220201122110221221
111011111111101111a1011111111110111111111010110111111111011111111111111a1111111111111111111011111011101111110001111111011111111110110101112021122211000211011020
111111111111110111a1111101011111111101111111111111101111100101111111111a1100111111111111111111111101111111111110111001000011111111011101021110122212012012101210
111011111110111111a0111110101111101101101100111111111111111111011110011a1111011111011101111110001111011101111111111111111111111111111101110222211121222202021220
111111011101011111a1111111111111110101110111101011111111001111111111111a1111011011110110111011010110011101110001111111011100111111111101111122102022121111202110
111111111111011111a1001101011011110111110011011101111110111111001101111a1111111110101011111111111101111111111111111111111101111111111010022211210101011211101012
111110100111111111a1011111100111101010110111111110111111111100110101010a0111111111111101111111111101110011111111111111011111101111111110010122202200101112222121
010111011111000111a1011011111111101111111011101110111101101011111101101a1001011111110111111111111110111010111111111111110111101100111111122212111111221222102120
111110101101101111a0111111111101110110012011012111212002121121022111111a1001002212011112011121211222112100101111111011001111111110111101110121022102112110122121
100111000110010111a1111111010110111012210211110111122112221210121211111a1110001211100221010211121222002012221101111011111101111110110111101200112212212020020211
111110101111110111a1100010111111111111122122002022222211122000011110111a1101112012112220120021211020022212021011111111110101101111111111111121210222211220211121
011111111111011111a1111111110010111110211121211112021012211121011221111a1111011022121102101221100121111021221111101111111111111111111011111120120111212210221201
111111101111101111a1111101111111011101222221112201202002122220022212111a1111112babaaaabbaabaaaaaaabaaabbabbbaaaaaaaaaaaaaaaaaaaaaaaaaaaaabbabbabbbababbbbbbabbaa
101110011111111100a0111110111101101111022101122202122222021122022110100a1101111b2221122120021222002122112211010101101111111101101111101102212222210122020222012b
111111101110111111a1111100111011110110120211022211202110021120210112111a1101121b2210210100002121202020221111111001110111111111001111010111111111111111101101100a
111001111101111101a0111101111111111112212122112011221102222120210021111a1110110b2120202222001211221212211000111100110111110001101101111111101110100110011111111a
101011101101111111a1110011101111101110102002122020221112200201122221001a1001121b0111011111112111111002101210101010111111111001111010110111011011101111110011110a
111110111111111111a0101011111100011111011121011222101012220111002220111a1111011b2101112022111120111120221121110101010111111101010011111011101011111111111011011a
101100101011111101a0101110111111111012112101222201221211002121201221110a1110121a1212111020121122021102002122111110111011111011001111111011111011101111111111111a
110110101011101111a1111110011111010112011120212112111211212200021202111a1111112b2222221222022221222021001221110111111110111001011111101110001110100101111011111a
111011111111011101a1011111011010100111121211112012112122111220120102101a1111100b0200202200110202222102122201111111010111101101110111111111111111111111101010110a
111110111111111111a1111110101111011112111222220111001010221210221112010a1111220b1022222222211220112121122101110111111001111101111110101001101111111111011101111a
111111111111111111a1111011111111111101102111220222122020111201112011011a1111122b2212211211222022221022220102101010111011111011101011111111111110111101111111110a
111011111101111111a1101111100111111112121121122012222022221110211121111a1111212b1212110222202222222222222221111111111111101110101111111011111111110000111111011a
101010100111111111a1111111101111101111011002201021122212110210211122111a1011122b0201201120221122222120222002011101111111111110100110101101010011110101111111101a
110011111101110111a1111110111111110101112122222111202111121212202211101a1111222b2121222221222022222122122202111001011111111101011111111111111110111101101011111a
100111111110111111a1111111011111111112220212202212102121122020221221021a1111121a0222221011112122222122220211110101111101111111101011111110111111111101110011011a
110110001111111111a1100111110101011011022112021011122222021202021012222a1111222b2011201221202222112222222222111101011111111111010011010011111111111101111111011a
101111111111011111a1111011111111101111110222221222222222212220012220222a1111122a2121202022001221222222001222111111011111101111110101110111110101111101111111111a
111011111111111111a1111010111111111101122212212102202222102122221222101a1011121b2112022022122121021202212020011011110111101110111011011111000111111101110111011a
011110111110101111a1111111001111111111201220221212120210222222200212022a0111121a2012210022001222122222022221111011111011111111111111011111000101101011110111111a
110111100111111111a1100111111110111110210122022101102120222022121120210a1111221b1102100202020200211211120020111110011111110111011111111101110111101111000101110a
111110111111111011a1001101110110110111002201222212022120002001222022222a0111112a2000220122211222222202122101011101111111111011011111111111111111101011111111001a
110110111110111111a1111111111111111110122222222112220212122020220212121a1111222b02221102200221222100222112111110011110111111111111111100111101111101101111111011
111011111111110111a0101111011111101111212220211122122122222111022202222a0111001b22011221001221012222212122220111111101111011101111111111111110110100010111100111
111111101111111111a1110111110100111102121222212122122010211222112020221a1111202b22021020120221022011211211211101111001110100011101011111111110101010011011111111
111111101110111111a1101011111111101112212000212222221222202220222122222a0111122b11222221122121120220212222221011110111011111111101101111001111011111011111111111
111111111110111111a1011111111101101102111222220022122222212201202022221a1011102a22022222222122222121222211211111111101111111111001101111111111111101101011111011
111111101110111111a1111110111111010112212120221221211212012121222212102a1011222a22122222212210120222211220001111101111111011111111111110011101010111000011110101
111111011111111111a1100111111111010101111010112221111102121112221001010a1101211a21202212120001210221221222111111111011111111111111111100111110101011111101111110
100111111001011111a1111111111110111111112022110212202121010221211202221a1111110b11121222220221112221021202110101010111110111010101111110111111111101100111110111
111011101111111110a1111101111111011111111100120212102201120122101110101a0110110b21201022220102200021022022111111111111011111111111011101111011111100111111111111
111111111111111100a1110111010101111011112222212122120221121212122121022a1111210b21011120120222220022222002210100111101011100011111110100111111111100111110111111
101110101111111110a0110110111110111111111012111011211011021020212021212a1111110a00121222121001122102111221110011101111111110011111110111111111011111111111111111
111111111111111110a0011111111111011111111221122111121221121102020111221a1111202b20001101120222221221112121111111111111111111111101111011110110111111011111110110
101111111111101111a1011111111110111001012122121122112012112221122022022a1111212b12111212221200021200021102210111111101111011111111101001111110110111110011110110
111110111101101111a1001101011111111110012210101121001212011111211221101a1111122b11011210120101122022011102111111111101111111110110111111101111100111011111111111