148 75
24 106
82 87
148 3
66 104
81 11
138 115
90 37
155 9
126 38
11111111111110111a111111111111111111111a1111011110111111111111100101201111211101010120221221211111111110a111101011100111001101111011122110122022b212101122211201
11101110110111111a101111101111111111110a1011111111111001111111111122112202202121111101112121221021101011a110011110110111111011111101111020121220b120222212212201
01111111111111010a001001011011110111111a1110101011111101111110011000221222021211112220121210211221111111a111101101111101111110111111101101212221b222112122012222
10111111101111111a111111111111100111111a1111111101111110101101111120110021220002112121110021212210011111a111101001111111011101111111122111121222b012212212020012
10111101111111111a111111111111111111001a1101111111011111111111111112212222112221121212010220122111101111a111110111101111101011111111121121122222b222120222022120
11111101110111110a110011110111111101001a1111110111011011111111110022111022111212101210221212011111111111a110111100011111011111111110121022021212b122222022222201
11111111100000111a011001001111101111111a1111110111110110111111110122122211121221221022221122201221110110a101111111011110101111111111121220122021a120202022002012
01111111011111011a110111111101111111111a1111111101100111111111111021022112211111002211102012120221100111a111111111111111111010111011111122212222b221021222201022
01111001111011001a111010011110111110011a1111111111101110111101100122222220212000211121110122211021111111a110110101011100001101100111012102211122b020221100221022
11111111111111111a111110111101011101011a1111111011111111110110011102102201121201212121102210121210111110a101111101111110111111011101122012122200b122121222120222
11111111111110111a101110111111111111101a1101011010101011111111111022222121221002202200111201121201111111a111110111011101101010110110122222212022b110120111112202
11010101111011011a011011111101101110011a1111110111100110110011110121001222100212121122212102112201011110a111101111110011111101111110111212212212b122222002222120
01101101010011111a111011011101110111111a1111101101011111111111101122022121101121222211011211221221111011a111010111111111111010111001122021111122b202222020212220
01101111011111111a110111111111010110111a1101111110110111111110111112202211212111122100111120201120110111a110111111111111011111011011102011112021b220012212222200
10010111111111111a111011100001111110111a1111000111111110101101111111212020221221121110112022101210111111a111001111111111101111011111120201212220b220221102222210
11111111111111011a111111111111111111011a1111111111100111111111110112212201111211220111121212012221011111a111111111111111101111111111122220210222b221000122012122
11110111010101111a001111101110111001111a1110111101111111111111010002120202212220121022202112120021011111a111001111011111101111011111102211212210b012122122122121
11011111111111011a111111111111011111011a1111111111011111101111111102120102202211202122112202101111110010a111011101101100111001111111121222120012b221100222022222
11101011111111010a111110111010111111111a1110111100101111110011111020112222112102202200200211212211111111a111110100110111011110011111112202220222b222002222022110
11111111101110111a110011110111111111111a1001110111101110111111111121111022222121121211201110220121111111a001011111111111111111011111110111112012b112110112020112
11011111110101110a010011110010111110100a1001111111111111111111111112112112121110202210222021121121101011a111111111111101111101111011111111111212b011001102121121
11011111111110111a110111111110111110011a1111011011110111111111111111012200122212121221022111110121101111a111111101111110111111111110011111012210a022122022112112
11011111010101111a011111111111111111111a1111111101111111111111111112210102212221220202002100222220112210b211010001110111011111010111111011012112b112002202111202
10111111110101101a011111011101111111111a1111111111011011111111110102022221112120201221221202222021112021b111111120022001111110012121201122022120b222120221111011
11101101111110110a111111110011111110011a1111110111101111111111011021012210122222200212221222022212202002b211110102021101121202011022112121220110b222121120022021
10111111110111011a101111011111010011111a0111111011111011101111111111201211022102222122221220222010211112a011101101100020222221221002122212210110a111001101011111
11111001011010111a111100111111111110101a0101111010111111111110111101222111202122020200122020022022212011b111011211222222211110022112221211121211a111011111101110
11110111111101101a101111101011001101110a0011111111110111111111011000101101102102111000021210212121202010a111010112201221221222111122222001011111a011101110111111
10111111011110011a110111111110111111111a0110010101111110111110110010111110022101020222202210202222211210b201011111210021112111100010112120121201a101001111111111
11111111111111111a111110111111111111000a1001101111101111111111111111011110122212102121122221111121212212b200111220120201112021120020202211112201a110111111010101
11111111111101100a111110110111011111111a1111100111111111111111011111111111021012121222212201112100202202b101010112211212110121201212122210222001a001111110111111
10101001111111111a011110111111111111110a1111111111111010111111111110111101010102211111201221120120011222a211111022210122221112221112121202211010a111101110111111
11111011101011110a010111111011100111101a1011111101101011011111111110111111112111020202222121121120101112a111110221221020122011021211211210112211a111111111111111
11111111111111101a111111110111111010111a1101111111111101111111001101111111011122200110211112101222112210b101111212212122112202211120121112212100a111101010110111
11011111111111111a101111111101111111111a1001111111111111110011111011111010112121022101121111102020210221a211110012022021112210111011222221122111a111001111101111
01111111011111111a101110111100110111010a1111100101011111011111101111110101122211122122012121122222100222a211001222222221210122222222012120121011a010111101111101
10111101110101101a110000111111111110101a1111010111111110010101110111111111121222110200001021212021201212b211111222211201112111221222212111021211a111001100011100
11101111110111110a011101111101110111100a1111111111110111111011111111011111011122220121220001111212111021b211001122111021001021100222211112201001a111111011110110
11111001111111101a111111111011111111111a1111100101111111110111011111011100110211222101212211222220201111a111111111111201221022011222122102120111a011011111111101
01111101111111111a111111011110111101110a1111111111111111111111111111101011112211220102222201021002220001a111001110102202110120121222201112100211a100110011110101
11111011111110111a110111110111111111111a1110101101110110010111101111001111112222112222221221021222010202bbaaaaabbaabbabbbbbbbbaaabbbbbabbbbbabaaa111111011111101
11110011011111101a111111101110111111111a111111110111110111111111110111111010001122210011220111220212110112111112121111220122010112121120212211111111111111110110
11111101110111111a111011110111101111111a111110111011001111011111011110111112211021221222222022212122211022110102111001101111211111220211111122111111111111111111
11111110111111101a111111011111011111111a111111011100110111111011110111110100120120111022222122220211112222001012221202112222211202012001202010011111111111111101
11111011111101011a101111111111111110011a110101111111111011101010011111111102212212112122120122211102102210111112122122222211110021011212211112111110111011101101
11111111010111111a111110111011110101111a100111111111101111111111111011110112211022112121221120121210121002011110212210110100001211012021021021111111111101111111
01011111110111110a111111110111010110111a101111111101101110111110111111111112122102201011121210111111112222001111122020221111211222112012211112101110111110101011
11110111111111111a110011111011111111101a001110100111011101111000111010111012110212100202201010121120001202111110221022011111111022111121212202101111101111110111
00111111101111111a111111101110100111011a011111001111101111101011100111101102012112211221220112122202121221111111020220012102112121111212111200111111101011111111
11111111011111111a000011111011111111111a111111110111011101010111001111101110102210211210010011111220111122111001221121211122212200211021221121111100111010111111
11101111111111111a110101011101111111111a111111110111110111111101011111111112212202211201012112111121110112100110010211212211201212221122022111101011111101101111
11111101011110111a010111111111111111111a011111011111110111111110111111111111212211221202022012110100021201111010111211221121112210102002121221011111111111111111
11111001111101111a111111011111101101101a110111110111110111111111111101111011022021221220210201211110022112110102111212212221222212020211221112111110111110111111
11111110100011111a011100110111111111111a101101100101111100010011101111101011111101101111110011111111111110110011101220222222110221211021121121101110111101111110
11111111110010101a101101111111011011111a111111111111111110101011011011101011011111111101101111111110110111111001000111011110001111111101111111111110111101111111
11111011110101101a111101111101111111111a111111101111111111111101111111111010100110111111101110110011111111111111110010110111110111010111111111111111110001111111
11111011011111110a011111110111110110111a111111000111111001111111111111111101111110111111111011110111101111101110111111111101101111111101111101011110110111110001
11100101111111111a110111011111001011111a011111101100111110111010111101101110111111111111111110111111011111100111011110111011111111101101111101010101110111110011
11101111111101111a111011101101110010111a111110101110111011111110011111011101101011111110111111111111111111111111110101110010111101011010111111111111111111101111
11111110110001111a111011010111111001111aaaaaaaaaaaaaaaaaaaaaaaaaaaaaaaaaaaaaaaaaaaaaaaaaaaaaaaaaaaaaaaaaaaaaaaaaaaaaaaaaaaaaaaaaaaaaaaaaaaaaaaaaaaaaaaaaaaaaaaaa
01111111101101111a110101111111110110110011110111111111111111111111110011111011111110111111111111011111110011110111111111001111111111111111111111111111011101110a
10011011111011111a111011001111110011111011111111110011111110111101111111111111110001110111111110111101111111110111101111111011111101011111111111111011111111111a
11111111111111111a111110111111111101111101011001011111110101111101101111111110111011101101111111111111111000110111101111010111111110011011011110111111100111111a
11001011111011011a101111111111100111111111111111111111101100111111110100111110111101011111100111111101111111110101111111101111011011111110111110111111101110111a
01111111000111111a100111110111100111110111011011101110001011111111001111011111111111011111111111111011101111111111111111101011110111101111110111111111011011111a
11101110010111110a011111111111111111111111111001111111111110111101011111101111111101111101110111111111100011101111111011101101111111110101110110110111111111111a
01110101010111111a111101111011011111111111111111111110111110110110110111101111011111011111111111111110111111011000011111111011011101101111000011111111101111100a
11111111101011111a111111111111010111011111010100101111101001111011011011011010111111011101101111101111111011111110110001111111111111111111010111101111111101111a
00111101110111110a110111111111111101101100111111111101110010111111111111111111111110111011110011111110111110011011111111110111111111010111011110111111011111101a
11101011101101111a100110101110111110011111111101110111000111111111111011110111111110111111110111111111111101111111111110111011011111111110110111111111100111111a
11111111101111111a010111111100111111110111111100110111111111111011111110001111111111101011111111111111001111111111010111111101110111111111111111111111111111111a
11011101110101111a111111111011011111111111111011110111111011111111111111111110101111111011111110111111111110110101111111111010011111111111111111111110111111111a
11111111000111010a111111110101011101111111010011011011100111110110111211011221001021021221212221221111100111111111111010011011111111111111111111111111111111111a
11001011110111110a110110101111111111011101111011101101110111110111122122200102112210102110122010200111111111101110101110111011101101101101011001101110101110111a
10110011111011111a111101101111101011111001111101111111011101111001121102011221201121212122220211121011111111010011110111100111110111111111111111110101111111111a
11111111101110111a111011101111111110111011111111111110111111110110111200221211022001101111122122000111110111011111110111111111111111110111011111111111011111110a
11110000111110111a111111111101111110111111101111111111011111110011112112221201122211211101122110221010011100101111111011111111110111111111110111011010011111111a
11101111110011001a111011101111111111101111111111111111011001101111011212120022012112202111112022221111111010000101100011111111111111111111010011111111111111111a
11001110101111101a111111111111110111111101111111001100111011111000110222220021201100211010022202000011111111101111011111101111011111101111011111111101001100111a
00111111111011111a1111111100111111111010111110011111110111011101111012012222122211022111aaababbbbaaaaaaaaaaaaaaaaaaaaaaaaaaaaaaaa011111100111010011111110111110a
01111001101011110a1101011011111011111110101111111010101111001111111212211221212012010101a101211110111111111000111110101111010101a111111111111111111100111111111a
11011011011111011a1111111011010111101111111001101111111111111111111110111202001121221102b112120222111111010111111101101111110101a111110111111110111111111111101a
00111111111001111a1111111111110111111001111011111111011101111111111012200122221222120102a221121222101111111001101111111101111011a101111101111111101101111011101a
00111111111111011a1011100111011110010110110111010111011010110011111012100210221211202212b122221211111111111011011111101011111111a111100111011111101101111111111a
11111110111111111a1111111111011111111011111111111111111011111111111212112221221111222102b120201220111110111111010110111101100111a001111111101011111111111110100a
11111111100010011a1111111011110011111101011011110001100011111110111122012122012220222111a210221122110111100111101011111111011011a111011010011111100011111100101a
10011111101101110a1011111011011111011111110101011111101010111111111012201120110112122202b211111221111111111101111111111010011111a111111110111111111111111111011a
00111111111111011a1101111011011101010110111111111101111111110111111110001211112201121200a200211101011101111111111110111111111111a110101111110111100011111110111a
11111111011111111a1111110011110110111111011010111011111111100111001120210022121112222110a122101112111011110111011101011110101111a011111111111110111110111101111a
01110001111111111a1111101111111111001111110110111111221011202100211222202222201112120121a222221100111101101110111111111011111111a100111001100111011111101111111a
11101110110110111a1100111111111111111111111111001010112221012210021202022222122022220112b121122221111101111111100110111110011111a011111110111101101110011111111a
11111011011111001a1010111101111100111111111111000011111122012122112212022221201212222122a220202012111011111011111111111110010111a110111111101101111010111111001a
10001111011011111a1111011111101111111110111010011111111021201212122122222012120020222112a202201220111101101111111011111101111111a101101111111000110101111111110a
11111101011111110a0111111011000111111110110010011111110121001120011202201201222012212120a102111102111111111101111111111101101111a011111110111111010111111111111a
10111111110111111a0101111110111111000101111111101012211101222221111210212121122201202102a220121222110111110101111010011111011101a101110111011111111110101110001a
10101111101111111a1101111110101011111111111110111011111111222212121202220220210012121221b002212220001111111101111110011111111111a101111011111101111111111111111a
00011111111111111a1111111111011110111111110100110011202110220020102221112210200210202110a121112222111111111111101111111111111111a111101111110111111111011111101a
11111011110110011a0101001111111100111011111111101101111200111022100120222212212211211022a122121122111111101111110001111110111111a001111000111111111101111111111a
11101011011110111a1111111111110111111111010111011012121200222111001020120122221022202212a111101121111111111111111111111111110001a100101111101111001111111111100a
11010111111010001a1111111110111011111111111111111110021011120220122110000121222022211100a210222121111111111111011111001111110101a011011111111111111111111111111a
01110011111111111a1111111011111111111000111011111100021120222212012111212221001212120111b121101211111111011001000111111111102211a120100220110012220200221111111a
11111111110011111a1001111101111100111111111011011111011011220211211200222112112221221221b122212212111011111010010111111101101212a211121120000120102211020111111a
11111110111110111a1111111111111111101111101101111111110222222112211222212102202221220021a022201001111110010000111111101111102212a202100222110112011222011111110a
11110110010111111a1011111101101010011111010111111111112210222212120111112212121201101111a110111111111011111110111111111111102112b212022102022120102022202110101a
00111111101011110a0101111111111011111101111111111102010222011221201122122202222122111111a111101111101011110111111111011101110211b120121112111122012212111211111a
11111111110111001a1111011111101111101111111011001112022221112122212112221112211220110111a011110011111111111111011111110101120210b222012201101011101210121211011a
11011111111111111a1111111111101111111101111111111112220120112100121212111210100212111111a111111111111011111111101011111011110101b010211202221222022212011101110a
11001111101111111a0111111111011111111111101110111111221102021110111112121222210011111101a011111111111111111111111111111111120110b121112220100211112210222211101a
01011111011101111a1001110101110111110011111111111112111112220111012112222222010112101111a110011110110111011110101110111111121011b221002111012110122122101201101a
11111111111100011a1111111111101111111111101111011010222102212212112012222021211222101110a111100011110111111101111101011111111222b120012120121010121121120211111a
11011111111110011a1010110111111111101101111101111110120112112021211121211202211011111101a011010011110000111101110111111111102000b212222212211211221222021101110a
11011111111101111a0111111111101111101000101110111112221120012111002022020012212120101101a110011111111111111110111110110111111211a112222220112222222121200211110a
11111100101110111a1111110111101111111011100101011111111022200211222212001011110210111111a111111111111011011101111110111011122011b210122001221222021120110211110a
11111101101111111a1111110110111111100111111101111110202001201222101120110210002211010111a000101100111011110011110111101111121021a120212121012122021112012010111a
10111001100001111a1111110011101101111101011010111100001120111122221120211102221202010111a101011101111010111111111111101111011121a021211222021122221120022110111a
00011110011101101a1011111111110100101101011110111112111120122001120110022122012201110101a010111111010111111011010101011011010122b212212021101201222221112201111a
01011100101001011a1111111011110001101101011111111111022021121100220220210121102020111111a011111111011111111111011101111011121222a101212121212122120102211201011a
11000011011111111a1111111011111111101110111111011111121121122011210012222112012202111101a111011111111111111111010101101110001120a111201212210120111200012211111a
11111011111101101a1110111001111111100101011101111112122010121221221121201221212112100111a001011111111110111101101101011011121112a211212212211121211022212211111a
11111110001111111a1101111110110101111011111111111011212122221200001120121121112111111011a111111110111110011111110111101110122212b212111122211200010210211111111a