137 114
1 45
117 14
139 42
75 17
0 52
76 71
56 67
16 88
118 63
1001101011111101111111101111010110101110101101011101111111101111111111111101111000110111101111111a010020221221111121101021111200111211a0111111111111111111011110
1111111011101101111111111110111111111110111111101110110111111111111111111110111101111101010111101a111111220121111000010221111122111021a1011111110001111111111011
0111111111111110100111111111101101101111111100111111111111101011122212022021222021111022101111111a111121102120012212211212122111122121a1111111111111111111110101
1011111110111011011110110111110111111101111011101111001111112220220212121120211021211220222111111a111111212201222221221221212121210111a1111111011111111111000111
0111110110110101100100011101110101110110111111111111111001112201202022120212220102011001121111111a111121100121122222101220222121021221a1100110111101111111111111
1010111111111111101111111011111111111011011101111001111101112111222111210112222002121212211111111a111010102201102211220120211212122111a1011111111110110111101010
1111110111001111111111111110110101111111110110001111000111111212022212211120110222112202120011011a111121002211221110111212202012120001a0111110111111111111111111
0111111111111010111111111111010111110111110111100111111010111121101220212212211122122012221110111a001110101021021201111101221222011121a1111110111011111110111100
1011111111111011101111101110111101111111111010111111111110111002110022201011202102101211112101011a101122122222122122221122220012110211a0111111011111101111111110
1111111001111110111111101110111111111001110111111111111011112211022212221122112111000121010001111a111102121112011112121111211122021211a1111111110111111111110110
1110011111111111101010101111111111010010111111111101011110111110121021202222122111102212021111111a101120212021122222221122212012102121a1110111101101011101101111
1111101011111110111101111111111101011111111111111101010111100112101112212210202022211121021111111a111110011212101200021112211112212111a1011110111111111111101101
1111111110111111111011011111101111111111111111111110111111101211121111221022221222202100011111110a110110211121211121212111221121112211a0111111110111011011001111
1110111011101111111111001011111111011011111011101111101101111112112022100221021122211212212011011a111011121221121102111100221112121121a1111111111110111101111111
1111111111111011011111111111110111111011111101010111111111111102012212112020221222222222210111111a101121122112011221101111210211020220a1111110111111110110110111
1111010111101111111110111101110111111110111101101111110111102202020211021010122112022220221101011a001120222110021221221012122212122021a1111111111101110111111101
1110101111111111101110011011111111101111111111111110011111111112102001212211112110211210211111111a110110021121122212122212120221112211a1111101111011111110010111
1011101001111111011111100101010101110111111111111111111100112111002120211202011200211012222110111a111101220222221012212121120022120111a0011010100101101111111011
1010111111110111011111010101111111010101101100111101111111112222201212222111110102222122110010101a111011111101102121112221112221001111a1111110101111111111111111
1101011101110110111011111111101111111111111111111011111111101211221110100021112101121221112011101a111111121102102022000211212122111211a1001110111110111011011101
0010111111011111111111111011111111111011001111111111011111102201110222222110112001121200112101111a111112012121111010202112222112111220a1111111111111100110110011
1011101111111111111111111011111011111111111111101101111111012200221202121221011212212102201110111a111101210110111122110122212111112221a1111111111001111011111111
1111111111111111101111110111111111111111011111111110110111002002010200221201210112221101122111111a001120222112111221220122221121111201a1111111111111110110111011
1111111011111110110111110111111111111111111011111110110111112010200121001012200220022221021111110a111101222010111202121022222000121211a1111111110111111011101010
1111110111111110110111111011111111111101011110111111111001111012122222120111210221120222121111111a110110221110222000202002221201121111a0111111010111011111111111
1000101111011001101111110011100111011111111111011101111111112012212111022102212112222210211111010a101021102221222212022011220111112121a0111111011001111111111111
1010111111101111111111011111111111011110011111111110101101010212121211101121011021111212222011111a111102111121212222101021220222121100a1111100111111111110110111
1111111111110011101101010101111110111111111101111011111101112221012011122200001110202002022101111a111120220021200111022222222220122022b2210210221212112211211111
1011111101101111111111111111111111011111110111101011101111112010021111211022211210001102112011011a111112111221212212221211121220222022b1111121101011012111111110
1111101111111011011111111011111110110111111111011110111110111021021101212200102112011111112111111a110122212211211112121122022122222210a2220121220101010222011111
1101111111101101111011111111110111110111111011111111111111001202212221010220211102220220100111111a111111110100101111111111112211112221a0022011001122102102001111
0101010110111111111111111000111111111010111111111111111010111022211111211222011111111222122111110a110111011101111111111111110110212101b1001212121010122120001010
0111111111110111111111111101011111011111110101110111111101112122212012221121211110210211211101111a111111101101100110111101010222211211b1121012022101222001101101
0011110011111111110111110111011101110111011010011111011000111111111111111111111011111111110110111a100111111111010111111111111212120010a2122221212022221202211101
1110101111111111111111111111111010111110110011011111111111011100111110011111111111110111011101111a111111111111111111101111011012101112b0102122101222201120211111
0111011011111111110101111111101111110011111111111110111101111101111011011111011111101111111111111a111111111111101111111101001222201110b2210112012112202021211111
1011111111111111110111111111011011111010110111111100000111111111001011111111101111111111011011111a111111011111111111101111112122200202b1201111212020122001111110
2202110221101001111111111110111111100110111110110111011111111111111110111111111111110111110111110a111000110111110011101111111221220111a2211221201120021122011011
2201110012011121111111101111110111110101101111101111011111111101011101111111010111111111111010111a111110000111111011111110110212222210a2210001200122012122211111
0121122210202021001111110111111111111101011110101111111010111111010111111011111111011011111001111a111111111111011011110111100121212121a2112121212200121222011111
2112202121101211001111111011111111111111111110111111001111111011111111101110011111111101000111111a101111111111111111111001012011222122a1221201021211100222110111
0201221001021211111100001101111011111001110111111010111111011111011111100111111101111111111111000a110110111111111101110111011102002221a2120222120021221122111101
2021220221010102111011110111101110111010111101111111101111111111111110111111111111111011110101110a010101111000011111111101102102112102b1112221121221002121111111
1201122012210012110101111010111111111011011111011101111111111111111111011111111101010110111011111a011111101111111111111111101012221111b1111002102120221122211111
2022112211011200101011111111110111110111110011110101111111111111111111111100100100111101011111101a111110110111111111111111101211210122b1121baaaabbaabbbaabaaaaaa
2102211001211022001111111011111101111111111111001111100111101101011111111111111101111011101111111a110111110111111111111111112112120222b2020b0000220100111111110a
0000220102222102010111010111110011111111111111011111011111111111110111101111111110110111101110111a111111111111111111010110112111211121a0122a1212221221002021111a
2101012210212021101111111111111111111001101001101111110011010001111111101110011101100111001110111a110110111001110110111110012222000112a2121a1222221110020111011a
1012021201220122111011011010011111011101111111111011101101111001011110111111111110110110111111111a111112211021101110221200102202222222b2202b0211101222111001101a
2022112000020001110101111111011011110011111011001111101111111111111111111011111011111111001110111a100110120212121101211101222222201202b2221a1122102011220210111a
2202212101112211111101111111101111101111111111111111011011111110111111110111111111111111001110111a101011122112112122102001022202222002a1201a0222211012221011011a
abababaaaaaaabbaaaaaa1011011111111011110000111111110111111111101111111011110101010111101111111011a111110201211212021121211112222100010b1101b2221021222112121110a
21010101112100121111a1111111100111111011120211220122012202102221122221211011111111111010111111101a100110012110121110121221012212100212b1122a2122120120020021111a
22212120221112221111a1110111111011111111021210102110120121211110222112201111001111000101110111111a111112122202111211222100212221220210b1011b2102221120110101111a
10111010001111211110a1100111011011111111112221202212222121122201121111111101111111011111111110111a110111211101201121001221201022122222a1112a2220021111201001011a
01012122001201001111a1011111110110111110022222221210112222211222010112101100011111011111111111111a111111112012112212212200022222020022b2221b0111201221211101110a
21010021112211110111a0101011111111010011111221211121211202221002220122211221212202002200222111101a111112101101222001221102221222022022a0221b0101121012121121101a
11210111121111101011a1111111111111101011102010001212220021222020022222102122211222002001122111111a110112220000212022102011122122112222b0012b1022121221201001101a
12200111221111211111a1001111111111111111110202210122220212121200221222121111121010012221121100101a011101222211120221210121122202201202a1111a1111101101110101111a
22221201211121021011a0101111101111110111011211211220221221202220220112121221012002012121102111111a111112001202112112122222021212221022a1111a1110111101011111111a
12121111221011211110a0111111110111111101111212110021111211212102222102212112202210111111121211111a011111121021101222202020202021111122a0101a1111111111111111011a
10112222102122120111a1110011011111011111110211011112121110212221212020110010101201211211212201110a111111200211021111110022221222111121a1111a1111011011111111111a
12020120212211120110a1101110101111111111110222022112221210122220202012221122012122211001122001110a011001002122211121110222010211012022a0001a0011110011011011011a
11122021212212001111a1111101111011111111112111211212012122111220221102122212110121011221212111111a101112012220222011202221222111221022a1111a1111101110111101111a
00212201201011111111a1101111111111111111122012102211100022211021122220221002122212102020001100111a111112212211022021121122212022221011a1110a0111110010111011111a
10120111212211111010a1110011011111110100122111011222000221110222222212222110111222022100101211011a111111221222121112202122002122222212a1111a0011111011111111011a
12020212101021011111a0111100110111111111102111122221002212201122221210201222210100220200211211111a011111002212210112102001101000000111a1110a1100111111011011111a
02111122211220221111a1010101111111111111121020111200201112202012222222222212111201210101210001111a011111022221201111210012211010222222a0111a1001111111111101111a
01010110010011110111a0110011111100100111020221001122222212122220222222222222112001022211220211111a111001121111120211211211221112211020a1010a1111111101111110101a
11101111111111011111a1111111000011011111020110211112121111112122210021111201221221020221201210111a110001121212122122221012122010102111a1101a1011100111011111111a
11111101111011111111a1111001111100111101002221221221111201212202201222221112101122101022022211011a101112222100211212211121201122120102a1101a1111101111101111011a
11111110111101111010a1011110111111011101011220122000210122101100112102220121202121021211110201111a110101202022011122221012201120111022a1100a1111101101111011001a
01010111100111011110a1101000111101111111112221211220011121110222022202002220121212202212222211111a111100110021211201121112221012210121a1111a1111111011111111110a
00122020221010112012a2222110010211110111102101101022221112020022220221122121111220112121122210110a111111112202022211222100111011222122a1110a1001110111111101111a
11120102012211011212b0122021111011111111021102100102211012211222212102101202112112011212111211101a001011111111012121220002221122201012a1110a1110110101111111111a
11200222222011221112b0212211020101111111022121212210201211102202020202101002021212102222112211110a111112112011222201210221012202112120a0110a1110100111111111101a
12122110111020112220b1120202021111111011111211121110211222021211020112212122110221111012212111111a111011111210110220121112102221101100a0111a1110111111111101111a
11111110210122112212b1101021002111110111112112112212222020211222222122121002211220111222211201111a110110221121102021021111020221101112a1011a1111110101011111010a
12122112112210210021a0122010220211010000111101010111112112211221220222221211101222002120121111111a101101110222111110100121222120202112a0111a1111011111101111011a
12002120112012112102b1211110212111011111120101121210022110011201222222222211011102021222111111111a111100111111001111101111111110100101a0110a1111001010101011110a
11110201111210122020b1221122000111101111100201120011112220011102011222112112211022121022101211011a111111111110011111101110101110111111a1111a1011111111010111101a
02121222111012011121a1001122112111111111112122211101021011102221202210222120111121212220210211101a111001101111111111111111110001111111a0111a1110111111111110101a
10121211201202101021a1102121211211101110112202122111121210211222222222222221202101101201210101111a110110011111110111111111110111111101a0100a1100011111011101111a
02121201220202211110a1100212111110111111101111111111111011111210122221222002102222111121122111111a111101111111011111111111101111011111a1111a1011101111100111111a
10022121211022112102a2020212201211111111111110111111111101101111221102012111002121122020111010111a011111110111111100101111100101011011a1111a1111010111101111111a
11201212011212210112a2020221110210111111001111111110010101111221110112200122101110212111120110110a011111101101111111110111111111111111a1111a11111011011111111111
02221222210201211220b0111121200211111111111111011101111111100221112222012002112010222012011211111a111111101011111010011111111111110111a1011a10111001111010111111
10122011220111201201b1211221011001111101001101111111111001111111100011111110010011111111110111111a100001111111011100101111110001111011a1111a10111110111111111111
11110102121212002122b2110201001010101110111111111111111111011111100111111111101110111011111111111a111101111001111111011111011111101010a1111a10111111111111111011
12122220120202112222a0202100021211111111111111111110011111111111101111110111111111111101111010111a110110111111111111101111111101111111a0111a11111111111011111111
10001221210212220000b2212210112111111111101111110111101111111011110001101010101111111111111100011a101110011111111111011111111100011011a1111a11101111111111111101
12102101000222221121b2101222210111111111111111111111111101001111111110111111111111110111111111111a111100011110110110111111011111011111a1111a10111111101111011111
11121110100222222201a2012122100211001111111111111111101011001111011111111101101011111111101111101a111010110111101010111111111111111011a0111a01111111111111111110
11102211121112012111b2101021022010111101011011111110111111011111011011111011100111111111111101101a110111111111111111111111000110101111a1011a11110111110111111111
10222222221210001010a1102022100211111111111011111111111010111111111111111111110101111111111111101a011111010111111100111011111100011101a1111a01111111110111111111
12201211211222022211a2201112220010101111111101111111011010111100010111011101111111111111111111010a011111110111111001111111110111101111a0111a11011111111101101111
10212221011111210112b1211011212211111100101111011101101111110110111110111111111110101110111101100a111111111101111111111111111111011111a1000a11111011111011111111
12220122121202222121b2212122012111011011001011010111111111010001111001111111111111111110111101011a111111011111110111111110111001111111a1010a10111111101111111111
11111210221121211111a2020111122101001010111111111101111111111111111111111111100101110101111001110a110111101101000111111111101110011100a0111a01101111110011100111
11102110122112101110a0212102210011111111111111110000110111111111101111111110111000111101111101110a011111111100111111111011110010111101a1010a11111100110111111111
11211221220222012202b2112121112110111100111101011111111111111111111111111110111111001011111110111a101011111111111100110111110110111111a1110a10111111111101011111
02220220221102122222a2122121111111011110111111010100111111111111011111111110111111111111101110110a111101111111111111111010111111011010a1110a00111100101111111110
12100202010122021111b1020112200201011001111111111110111011110111101110111111110111111111001101111a111111111111111111011111100111011110a1101a00111111111111111111
11111220010121111121a0022012220100011111111100111111110111110111101011011011110110110101111101111a111111111111110110111111011100111111a1111a11100011101011111111
10110101011110101011a1111111010111111111011110111111111111111110111111111111011010111110111111001a110001111111011111111111001101110111a0011a11111111111011111111
01101111011111001110a1111111111111111101101111111111111111111111111111101011111101111101111110100a100101011111111111111101111111011111a1101a11111111111011111011
11110111111111101111a1101010111110111011111111011111111011111101111100111110011101111101101001111a111010011011001011101111111101110110a1011a11110010111111100111
11110111100111111111a1111111111101111111111100111011111110011101111111110010111110101111111110111a010111111111110111000111110101110010a1111a11110110111101111111
11110111111111111111a0111111111010111111111111110110101111011111110111110111111110111110101111001a101101011111011111111111101111101101a1101a11111111111111111111
01011111011101110111a1011111111101111000111001100011101111111111011111111111111011101100011111111a111111111111111101101110111111111111a1111a11111111110111111111
11011011111101111111a1111011110110111110111111111101111111111111110111111111111011111111001111111a111011110111111111110110111101111100a1011a11110110101111110111
11011111111110011111aaaaaaaaaaaaaaaaaaaaaaaaaaaaaaaaaaaaaaaaaaaaaaaaaaaaaaaaaaaaa1111001110110110a011010111100111111111010110001111110a1111a01111111011111111111
01100111100111111111100101111111111001111111111111011101111100111011011101111101a1101101110111101a101111010111111101011111110110111110a1111a11111111101110111111
11111111111111111111111100111111011001011111111111111110101101111011111110100111a1111111111011110a111100011111011000101101110110110111a1111a11001111111111010111
11110111001110101110111110011111111111111111111111111110101100001111011111111100a0111011111101001a111111011111100111101111111010111111a0111a10111111110111101011
11011111101111111111101111111111111111110111101111110111010110101111111111110111a1111111100111101a001111011001100101111001111111111101a0101a01111011010111111111
11010111110011111101110001111111011111111111100111110101111111101111111111111111a1011101001111111a011111111110111101010010010111110110a1011a11101001111110011111
11111111111100111110111111001111101111011101111111111111111110011101110111111111a1011111101111101a110011111111011111111111110110111101a1101a11111111110111111111
11011111001011111111111110111111100011101101111011111111111111111110010111101111a1111011011101101a110111011011011111111111110111110001a1111a11011101111110111110
11011111100101111011111111011111111011111011101111110111110110101111111101111110a1101111010111101a111111001110111111111111111111111111a1111a11011101111110111111