134 8
12 58
109 118
45 76
86 98
2 73
96 115
20 102
8 28
118 11
11101111111110111111a1011111110011010111111011111011111110111111111101111101100110110111111011111011a102221221110222222011112211012120111101a11101110101a0111110
10111111110111110111a1011111111110110101110101110100111111111111101011011101101111111111111110111100a112002020111011212121022112022221010110a00111101110a1111101
11111111111111101101a1011001101101010110111111011110111111101111111111111111011100111011110111110111a110121212012212111121021212211011111110a11110000111a1111111
11111010111001001101a0101011110111111111011110011111111111011111101110110110111011011010111111010110a112121112001201211212202221010111110111a11111111111a1110110
11101110101110111111a1111111111111111011111010111011101101100111101111111111101111010111101111110110a011112101211112111122022111022222101111a01111101111a1110111
11111111101110101111a1111111111111111111110111101001111001111111011101101011001100110101111100111111a111010122201122021112222111111210110111a11111101111a0111100
11111011111111010101a1111111110101101101100001110111111111111111101101011111011111101111101011111110a111022222211101212112111020121102111111a11111111110a0111111
11111111110111111111a1111100110011111111011111001011110011011010101110100101111011111011110111111111a001021211101021221201112111111210010110a01111011111a1111011
10111111011111111101a1111111101111110110111111111100111011111111101111110111111011110011111011111111a000101211212021122021212121020022111111a11101011110a0111101
11101111111111010011a1011111111110000111110111111111001101111111111111100110111101111011111111111011a112120211221222202121222012210012111101a11110111111a0110111
11011001111101101010a1111111111110101111111111111101101011111111011111110111111101111111011111111111a110102112111021112011211221110211111111a11110110111a1111111
10110110111101111110a0111110111111111111111010001101111110110111111110001101110101111101101111101111a100101210111111211221020120121121111011a11111111111a1111110
11101100111111110111a1011111111111111011111011111111101111111111110101110111111111111110110111101011a101121122001011212211112011111121110100a10111111011a1110101
10211201022120211212a1221100101111111111111111111111111011010001101011000011111111101101111110011101a101201201022122121000121101222222111101a01111111111a1111111
01221111101201120021b1211111110111111111101110111110101111111110111111101111011111101110101101111111a101221212111112221111202112211010110110a10111011011a1111000
11111112211202221101b1201111111101111111111110111111101101111101110111101111101110001111100111110111a101122012202200210110111021222221010111a10111101111a1011001
11001011012122222011b1201111010011110111111110011110001111010011111011011100111110110011111111101111a012221010122112111210121111102022111011a10111110101a1101111
01212101111021201110a1201111011101011110111111100100010111110111111111111111010111110111010111110001a111221021110112121222122021121211111011a11110011101a1111101
21200221121101122012b2111110111111101111111011111111111011011111111001111101111111111111111110010011a111221021110210221111111212221211101011a11111111111a1110111
10210111121111112112a2001111010111111111111111011011111101111011111111111111011110111111111111111111a111010012111111111202110120110221111101a11101110111a1110101
11110211212221121210babaaaaaaaaaaaaaaaaaaaaaaaaaaaaaaaaaaaaaaaaaaaaaaaaaaaaaaaaaa1110110110110110101a1112221002011022121bababbabbbababaaaaaaa11111111011a1111101
12022221222222211211111011111111111010110111111111110110111100111111111011111011a0110011110110111110a0102222110221211212a2212110012122101101111111111111a1101111
01110121221101210200120211011011011110111111110000111111111110111101111111111000a1111011111111111111a1101210101221122120b0122021121121111111111111010100a1011101
11111122002111111111102211011101010111011111111111111111100111011101100111111010a1110101011111110111a1011021211010212121b2112012200121111111111101111111a0111111
22211102200122022202112211111111111111110111111111111111111010100111111111111111a1011101111010111011a0020111121011111100b1021100010122110010111111110111a1111111
21010202221212210212022201111111110110110111100101110111111111111111111111111111a1111011111101111101a1122200210212012211a2022122220220111110111011111111a1111011
12122221012022122211212110111111111111111010110111111011101111111100111000111011a1111110111111011111a1111220121201122112b2101220210222110100101011111001a1101111
11221201212112012101121111101110111111111111110111011111011111011111111111111101a1111110111010010111a1101111101000111111a1111111111111011111111011111111a1110110
21112111211111120212212010110110110111111111100111110101111101110101111111110101a1001111111111111111a1111111111111110011a1110101110111111011111111111111a1111111
01012102122201212011112111111101111011011111111111111111111111011101110111101011a1011111110111110111a1111111111111011111a1110101111111011110111111101110a1101100
22022100110101211212202211111111111111110011111011111111011110111111100111110111a1111111001101111111a1011100111101101011a1111011111111011111110011111101a1011011
21010001200221220010112110110001111110111110110011011111011011101011111101111101a1111111101011111110a0111111101101111101a0111011111111111101111111011111a1111101
22222122211102112020012200111011011111111111111001111111101111011101011111011111a0011101101011010111a1111111111110111101a1111100111111101101111111111001a1111111
01221012221212122211021211101011111110111110111101111111110110000011111111111010a1111111101111011111a1011111111101111100a1111111110111111101011001101111a1101101
11111121021200201202122111111111111011101111011111011101111011110010111111111111a0001110011011110001a1110110111110111111a1111011110111111111111111100011a0111111
11010211011120122110112210001110011110111101101011111111111111111111111111111110a1110111111011111110a1111111111111111011a0011111011111111111111011111111a1100101
11211020112212220201122211011111110111011011101101010111111110111011101110101111a1011110111100110111a1111101111111010100a0010111101110111011101111011011a1011111
11112211222112110201122011111111110111110111111111110111111111010111111110111101a1010111011110111111a0101111111110111011a1111110110101111111111011111111a1110101
20020012221221222111022010111100011111101111111111011011111111010111011101100111a1110111111101111111a1111110101001111111a1101111011111111011001101111111a1011100
11101221211001002020011211011111111111110011111111111000111101101011110011100101a1011111011111101111a1101010111011111111a0111111111111111111111111111111a0011110
02121101222120122111220211111111111101111011111111111101101111111111110110111101aaaaaaaaaaaaaaaaaaaaa1110111111111110001a1111011101111101101011111111111a1110111
222221112111100012022220011011011001010111011011111111101111011101111111111001101101111111111011111011101101101111101110a1110111001111110101111100000101a1110111
120201011111121002221222010111111111110111100111111111111011111000110011111110111001011111111111110111110111111111101111a1111011111101101001011001111111a1111111
212210211121222111201202110011111110111011111101011110110111111111111110111110111111111111110111101111011111111111111111a0111011111101111110111111110100a1111110
111111111110111111111110110111110111011110111111111111011011111101111111111111011111101111111011111111010011111111110111a0001000110000111111101111110011a1101111
100010011101111011111111011110111111111111111111011111110111111011111111101101111111111111111110111111011111101101111110a1111110110011111111111111111111a1111111
011011111011111111011110101100111111111111011101110111110111101111001111111111011101111111111100111011111101011010011111a1010010111111101111111100110111a1111011
111111111111110011110111101010111111101100111111110111111100011001111101001111111111111110111111110111011111111111101111a0111111101101111110111101011011a1110110
111101101111011111100011111011111100110110011111011111111111011100111110111011111111111011101001101101111111111111101110a1111111111110111110111110101110a1111111
111111101011111110111111010111011111101011001111111011010111101101111110110001010110101111111111111111110100111101111111a0111111111110110011111001101111a1111111
111111111101001101111111111011111111111001111110100011111111110011111110101011111111111101011111111111011011111111110001a1111111001011111011111111111111a0101110
111111111101011101101111100111111011100111101111111111101010110011110111111100011101111111111111011111111111101110111111a1111011110111111110011000111011a0101111
101111111111111111111110111101101111001111011111100111101111111011110111111001111011101111111111111011111101111011111110a1011011111111111111001111010111a1111111
111101011100001111110111011101011011011111111010101111110110111110111111111110111011111011101101100111101011111111111111a1111110111111111110001110111111a1011000
111111111101111011111111110111101111111011111111010110111111111111111111101111101111011001110111101111111111011101111011a1110101111110101110111110111110a1101110
011111111111110111101011001111101111011110111011110111111110111011111111011110111111111110101110111101000110111011111111a0110111110111101111101111011111a1111111
111111111100011111111110011111111111110111111111111010111111101101111010111111111110111011011101110111111001111111010110a1111011011110111110111001010101a1110111
100110011111001111110110111011010110111111011111101101111000111111110111111101111110110110101101100111111111111000111111a1110111111110111000111111110110a1111111
111112011111221210010111111110111111100110111111111011111011111101110111101111111111101111111111111101111010111111111111a1011111111111111111111111101100a1111111
110211201021220211110111101110111110001011110111101111010011110011111111111111111111110111101111111111111101101011111111a11111010011aaaaaaaaaaaaaaaaaaaaa1010011
210202212122222120110101111111111111111110011110111111111111111111011011100101111111111101111111111111111110111111010111a11111001110a100111101011111111011100110
202011121101222000101101011111011202122222122121112211100221101101111111111101110101111101110111110111111111111011011111a10110011101a111011100001011111111111111
222012121222022201111111011111222011212211200002020112212111111111101101110111000011011100000111111011111101101111111110a11111111111a111110111111110011111111111
121222112121022111111101111111211222010202210221122221122222111111111111101110100101110111110011111111110111111111110011a10101011011a110111111111101111111111111
022212112110121220101101101111102112220022202012111121021222211111110111111111111101110111111111110111111100011111111111a11111111111a111111111111111111110111111
111112120121121221111101010011022211111111120211120012120222111111101011111111111101100111111010111000110111111111111001a11111001111a110101111110101110101111011
201111121022112211011100110111221212110221112112210222111222211111111111110101111011010111101111111111111011101011111111a11111111111a111111101011110110111111001
112201112220222221111010111011112221221221012212122212022121201111111110111111111111111001101111111111111011101111111111a01111111111a111110111101101011111111111
221211100211002122111111111111212120112212201011101222111112211111101011111111111011111111110110111111011111111101111011a11110101111a011011111111111111101101011
110112120111010121101111111111112200222200112211221011210222101111111110001100111101111111110111111111010111111111111111a11111110011a011111110011111110111101111
110201122220202010111111111111121122200201212012211221212212211101111110111111110100111011010110110011111011111101111111a01101110101a100110011111111010010110111
212222021212012220110111101110211020211221222121222112201201111101111111111101101111111110010001111111111101111110101111a11101011011a111110001011111001111101110
211212010202221112111111111000120210122222202221021121010112111110111110111100011111001110111101111000111101011111011101a11111111011a110111011111111111111011111
002002122112200222011101111110110121111221111112111121110211211101101011111111111000111111011111111110101111111111111011a11111011011a111011111101011111111100111
020112121202111120111010101111122202212212101221020200222112211101100111111110101011011011101011101100110110101111111111a10101110011a111011111111111110011011011
121101111111211122111101111111112022111111211222212001221110111111011111111111111111111011110001111011010011101111111111a11111111110a101111011111100110111111011
202111210020122221111111111110120121221211211011201211222202110010111111111101011111111011011111111101111110111111110111a11110111110a011111111001111111011111110
212221101102111211110001111111212221200221121210112012002112201111010110011111110111111111111101111111101111111111100101a11111111101a110111111111101011010111111
010201021122001211110111111110020211002121222000222022111011201111011010110111111010010100001101011111110111100100111101a11011111011a101111101111111111010110111
bbaababbbaababbabaaaaaaaaaaaaaabbaaaabbaabaababaabaaaabbababaa1001101111111111011111111101101111101111111110111011111101a11111101110a000101111011111110011111111
1122012222002110011111111110112212211111222112102022111220222a0111111111011010010110111111010101101111011010011011111101a11101101111a111101110111111111010111110
2221112221222111001111111111110201221220122010021012112010102a1110101011111111111100101111100011111110111111111011110101a10001101010a110111111111111111111111111
1012221011102120211011011010100022221222122122021022212210222a1101111111111110111111101111111111111111101111111111111000a11011110010a111111111011110001111011011
2010012121202111111111111111011122221021200212012010112221021a1111000112122102201122222211201112022212001111111010111111a11101011111a111011111111100100111011011
1211211221212220121111101011111211210202222212110021211110111a0111101110111122201211110222112220211022111001111111001101a10011110101a111011111111111101111110111
1210211001211101021111111110012102012221201012122110022111120a1111101111010202222211011012220122121112111110101111011111a01101110111a111101011111101111101011111
2211121220211200111001111111112220112101212202122221122010212a1111101111112111121122021221001010211011010111100101111011a00101111111a111111111111111100110111111
1022022121022222021221222102012102222210211121212122212221222a1111110111200212122111211202022212012222111111111111111001a11111111101a111111111111010111111111110
2122020202122212211222111000201120222121110112222221222102002a1111101111110221221121100221121120110122101111111111111110a11110111111a101111001101101111110111110
1011111202201212200201112101120222202211220111120010202220222a0110111110112211120112111121120201020221111111111110111111a11101111111a110110001011101111111011100
1111012111111211222022122102012201212102211220000120001211121a1101111102001221110112111122112120211102110111010110111111a11111011010a111001111111111111110111101
1111121120221001012000112022112222122212220210111022211001221a1111111111202212222111021212121022122012111111111111111111a11110001111a110111010111011111110111111
1111020021221212121221012200221221111111111100111110110111100a0111111101220021222121021011122021222222110101111111111001a00111111101a111011111111111101111001100
1111121112122222212211222101122222011011110111111101100011111a1111111112221021122220111121112110220102111110111111111111a11011111111a111111111111101111111001111
0111021211121202210202221220111211011111111111111011101100101a1110011110221120101210210211112121122212000001111011111011a01111111111a111111111111110111011011101
1111121111211211120212211211101120211111111011011011111111011a1111110111211112211122101221111012222121111111111111110101a11111111111a110101011111111111101011111
1111120022221011010120222211121221121011101111011101101111111a1111111101212121021111122121220211021211101111111110111111a11111111111a111110111111111011111111111
0101112101120111100212212221211222211110111111110111111111101a1010111101110001120202212111021111112211011101101101111111a11111110010a011101111001101111110011111
1111122112112212122012111022112110121111011001111111110101101a1110111112122211120122021220022012201012111000001101011110a10110101111a111111110111101100111101011
1110022222212222100222101211121222011111110111111101111111111a1111111110100211110021100121212001211211111100111111101001a01011110111a111111101011111111101111100
1011110220101222211110221111011011111001111110111111011111111a01111101012001201212221202112222220021aabaabbbabbbaaaaaaaaa11110111111a111111101110111111100110111
1111101110001122221211222012021011221100101111101111000111111a10101111102121111222022012221121222102b2222112121111110111000111111111a011111010111111111101011111
0001012102212111122222211102100102201011001101111101111110011a01110111021221011222202222002201220022b1021111122211011101111111111100a011101111011001010111111111
1011020211112011220111121212212211101101110111011111111111111a10110111111111222212211020222012022220a2122202121102201022122021111111a110111111110011101011111111
0101100201121211211002222121120120211011010111110111010111111a11111110111022110122221222122220202222b2211220120211110212202211100001a110110110010101111111111111
0111101212121222022202100220022112201111011011110111101110111a11111011001100011000122122220120122222a0222002222102121200212211111110a111111111111111111111111011
1111112211110111211220221102012222111111101111101111111101110a11111110111112121111211211000220221202b2220122122120202221211011011111a111111111111111101111111111
1011021212022220122102121211122112121111011111111100110111111a11111111121200222102212212021000222222b2221222200121201122120211110111a111110111111110010111111111
1111111210101111021112222222121022111111011111111011111101111a01011011122021222122222222200122212222b0122212222222121101012111101110a111101111111110111110110111
1111122120121121211122222110222122111111111011111111010011011a10110010021221221011222120022012202222b2122222121102211011111111111111a111011111110111111010101111
1110111222212121121220011212022112121111010111101111110101111a11011111012010120102112020222221022202a2220122222221110221021111011011a111010111111101111111110111
0011100121222221021121021222211022220111111111011111111111111a11110011102101101022222102212011220202b2112212211212011102121220111100a111111101111111111111111010
1011001120211221011120110211022112220111000111111111111111111a11111011012221011222122222222022222212b2222022202100210112111010111111a010111111111111111010110110
1111121120221221112111022022110112221111001101111111111101111a01111111100022121001222222202222122122b2201221202221201220210201111010a111110111110010101011110111
1101121221121021211121210221112110121010011011111111011100111a11111101111101111100001002010210221002b1202220210221120120121011011111a111011111111110111001111011
0100112100022201101011121110222012220111111110101111001111111a11011011111101101112012001210112222021b2220122120202110101210221111110a101100111111011111110110101
1101010012101121112110020122212221011101111101111101101011111a10111111111111011101222121102121022202b2112221222212112022211100111110a110111111001111110111101111
0111120101121102222200210222102110221110011111111111011111101a01111101011000110110122222010012011202b1122222222122122121101210110011a111111111101111111111010111
1111111101111110011111101111110111111110111101101111111110111a10100111011111110010210021220021221101b2202022201221211211212211011110a101011111111110100101111111
0111110111110110111111111011101111111111111111111101001111111a11111111111111101111111121222102221222b2202012220211222221111111111111a111111011011011110111101010