69 114
43 3
22 34
89 50
136 22
79 94
153 24
6 119
124 0
32 55
11111111111111111110110110011100111111111101111111111111001011111101101110111001111011111a1111111111101111111011212221221111201222102111122111111111011110111101
11111111111101100001110111010101111101101010111111010111111101111101111110010110111101110a1111011011011111111122011211222111102112212221101111101110110111110011
11111111101101101100111111111111111011110011100111100111111111101010011011111111111111111a1101100100111010100121112112201212110201001112211111111010111111001101
11111111111011011111110100111101011110110111111001100111011111011101111100101111111111100a0110111111111111011220121221122022111021010111110011011011100101101111
11010111111111101001111111011110111111111001111011110011001011111000111111110111111110100a0111101111111111111121021102110112221211010102122011110000111111011111
11111111101111111110110011110101110101110000100111101101101110111011111111111011111111011a1101110000011111100121222122101112200010012222202211111001111011111111
11111111111111110111111110111111111111111001011111111100110111111111110111111110011111011a1111111001111111111112111122120020111120211222121201110111111111111110
11101101111001011111110011111110111110110111011101111111110011111110110001101111111111011a1111101101110011110111121202101212020121210121221220102011212010111111
11101111111111111011101111111011101111111101101111111111111111011111101110001111111101111a1111111111111111011112212221121002022220222222121222120211012211111110
11111111111011011111111110111111010101111101111111110111101110111111011111111010111110111a1111111101111111101102211011122012222120202202001022102202222020122221
10111101111111101101111111111111110011101110101110111111101111111111011111011111111000111a1101111111100111111111220112020121222022201112122222220222211222012021
10010011110110111010111101111110111111111111110011111111111111101101111111111011110110110a1001001110110110001211100210021110010021222202212222110020200122212112
11111110011111101111011011011110111111111011101111111110111111100101111111010111111111111a1111111111111111010012011212111112001012222210122212102220020201212220
11111011110111111111011001111110110111111111101110111110111111011111011111111111111110111a0111110101111111100221222110212122202222012210202022012222022000201221
10110111110111110011101111111111101111111111111111011111111111101111011110110111110111111a1101111111111101111122211210012021022222221221212111212002021022101122
11111111111111111100011100101001111010111111011110111101110111101110111111101111111101011a1111111110001111111211121211101012002222202221222122112222222222221122
11110101111110010111011111110110011111111110110100101101101110111110101101111111111011111a1111100110111111111101111011111221122121212201102002212021122221212112
10111011011111111111011111011111111111011111111011111111111111001101111111111111111111111a1111111111111111101111010110111121112020111211021202222021022221121021
11111110111111111101111110111001111111101111111111110111011000111111111110111011111111111a1011111110110101111110101101111011221102101111211022222012210102101120
00111111122022022210220011202222011212111011110101111111111011111110101111111111111011111a0111101101011110001101000110110120110120020211221101202202001212122221
11011110112101212212212121121210122211111110011111110100111111111110111111110111111101111a1100111111111111110101111111111020110122212220012222022011102212022102
01111111101122002201012211012220021222110111111011111111111110110111011111101111111110100a1111001101111110111101111111111110121022012122022122212002221212000212
11111111020211012110110102200221111121011011101111110110110111111110111111110101111110101a1111111111011100111111011111111011212212100101022221220212122212211121
01111101112101111201021111121101110211101101111110011101111110101110101110110101111111111a1111100110101100111111111101111221212002222112121012202222122222121222
00100110001222211121122112011122220222011111111101111110111111110111010110111100011111111a1111000111110110111101111010011112221112111220202202122122222122022000
11111101201201222022111122221011220121011111101100111111110010111111111111111111110111111a1111111111111110111111111010100202221220112222122122112221221212021222
11100110112111221212122221202112202122110001111111111110111110111111011111110111100011100a0110111101101111100110111111110211122212222102122221122010021112102111
11111111122011120102112221222221111022110111111101011011011101101110111011111011111110011a0111101111111011111110101101111022012111221120210221201022222020011121
11111111012212211011002110122111011221110011101111111111111110111111011011001110101111111a1111111111110111111111111111110220212221111022021112122220021212221101
01111111201212212211210121212100212121111011111110011111111101111111101011101111111101111a1110101111111101100001110111111110022001221001222221021122201222121122
11111110111121011022122020112011212111111011111111101111101111111110111010111111111110111a1101111110111111111101110011001222110001001021111221222110010112022011
11111112200101111111220021111121211122111101101101110110111110111101111100101011111111111a1111100111111111111110100111111212111202121010122212022212122212120012
11111001211211110121210112002122222222110101110111111101110101110111111110111101101111111a1111111100101111111111111011110120121212012221010102221212222201122121
11101111211001220211101222102021210221111111001111100111110111111111111111111111110101011a0110101101101000010111111111101011220121021111020222222100200212220112
11010012101101201011211122211010020212011111111111101101111111111011011111111011110111110a1111110101111011110111110111110101221112122221022100022221222122111221
11111101120111212211001100122211212101111011111100000101111101110111111111211221211022122b2101210122010221111111111111011011111122222101012221102112202211021011
11110112222212212112121211102211021211011111111111110111111110111111011110221122121011011a2210222212211111101100101111111201101111212210120112200202220222121022
11111112212011221110012221111212212220111111111111111101111110111110111111202122101102211a1111121112122211001111111110111212120112122111102220022122212211212212
10111111122222222100211111122001201122101111111110001111101111111101110111220122000112211b2212221111102111111011111101000111101011111111100201212110122222020202
aaaaaaaababbbbbabbbaaaabbabbbaabbbbabbaaaaaaaaaaaaaaaaa1111101111111111101211210222122221b1110201022122121111111111011111111111111111101111021220222211222212221
111111122112012221221222220202021201102212211110111101a0111010110011101111120010122221102aabaabbbabababbaaaaaaaaaaaaaaaaaaaaaaaaaaaaaaaaaaaaaaaaaaaaaaaaaaaaaaaa
111010112121212221220122112202222221022022211000101101a111110011111111011111212211122212122212102012121121011111111111100110111101111011111011111001101111111110
111111111111212001022201220212121222222121221211111101a101111110011111011101022001021112010012122121201021100001111011110110101011111111111aaaaaaaaaaaaaaaaaaaaa
111111111212121210212012202120002010221012222121111101a011111111100100011100222222012020112212212211212201111100010111111111111111111111111a11111111111111111110
100111102100222122222212020022012012221022122111111111a010111110101101111121200201000101222012202021212221111101011111011111011110111111011a11111011101111111111
111011112021110100212121222022202001001221012210111111a111111101101111111112202110212212222010101210001021111111110101111111011111100111111a00111101111111111011
101111012121100110122101122221220020221101221120111011a101111101110111111100112222021211201102211112222000111101111111101110111111100011111a11111111110011111111
111111110202222112222212222222122112010122211222111010a001110010111101011122111220122021112221121111112221111001011001011110111111111111111a10111111111110010011
111011101221121222020000222222100222202121011202101111a111101010011111101110201121102121212210001222112110111111111110111111111111011111111a11111011101011111101
011111111101101112221201012012221222220012202202111101a111111101111111110122121222210111012221212222122210100110011111100111111111111101110a11111111100111101111
011111011011111111110220222121022222210122202021110110a101110111011101101120111211210201200111122121121111111111111111111110111111111111111a01111100001111111011
111111111110011011200120210120112221100111122212111110a111111111111111111110220222011022121221121212220010111111101111011110110111101101111a11011100011111101111
100001111101111000221122110100112122102221212022100011a111111111011011011112011221122220222221101221012011010111111011011011111111110111011a10111100111111111101
111110110111111012200222111110212222022121011002101011a111101111011111111121102202021222221120012002000211111011111101111101110101111111101a11110110011111110100
111110111111111112220011200101221222220211121010101111a001111111111011110112221111201211120221212212022011101011111110111111101110110101111a11101110011111110110
111111111011111110212102222212110102222112111220111111a111111111111110011102212211220022212210121211212021111111111111111111111111111111111a11111111010100101100
111011111111111102122202201112220112012202211222010101a101011110111111111102100221201200112222012111102011111111011111111111011111111111101a11111010111110110110
111111101111111001212222102211022021112212222211101101a011101010110111101112212210012222121211002111221111111111111111111111111110101011111a11010111100110110110
111011111111111111201212222212001202202102222222110111a100110111111111011112121212120122011010212201122211111110111101111001011111111111111a11101111111101111111
111110111110111111212212110220022212221021002210111001a111111101111101111021211122211122211011111221111201101111111011111111111111111110001a11010111111111111111
101111111111111102011021101021112221111112211101101111a111110111111111111111112020121211122112122210211121110111111110110111000111011011111a11111101111011010101
110111101011110112000121222022211111002121202122011111a110011011111001111111120200111021101122112001222211011111010011110010011111111100111a11101111111111110101
111111111010111112110112221122211212222201202112111100a111111010111111111100121212002001012221011221122120110111010110111011111111010111111a01111101010110111001
111111110011111111211122122020121122201011111112101111a111111110111111101112112211112112122212210120212211111111110111111111111011111111101a10111111111111111110
101111111111010011112121210122121212220222211010101001a111111010111011111121221011102212202121202010100010111101111011111101111110011111111a11111111110111011111
111110110111100111121211211112001112222111111112110111a101111110111101101010111201122211210122201110111111110111110111101111101111111111111a10001100111011011111
011011101011111012201110011120222111200122221020110111a111111110111110111110101110111001101111111010011111111110011111010111110110011111010a11001111111111110101
111111111010011011201022212122112020200222012022111111a001101111111111011011011111101111111011001011010111011111111011111010011111111110011a01111111011111110011
011111111111010101012112221021120122012211111211110111a111111101111111111111011110101111111110111010100110111011000101111111111101111111101a11111111111110111111
101101111111111111222122021002102110010021112101111111a111111111111111111111111111010110001101111101011111011101111110010101111001101111111a11111101111111111111
111110111101001112111122100220222121101102001011111110a111111011111111011101111111101110101101111111010111101111111111110111011111011111111a11111101111111101110
101011111101110011001110101111100111011010111111011111a111101011011110111111111101110011110011110111111111111111111111111101111010011111110a01111111111111010100
010011111111110111111101111111110111011110111110111111a011111011111111001111101111011110001111111100111111111110111101111111111010101111101a10111111101110111101
111111111111111111001010110111101110110111111111111101a001111110110101111111101111101111011111111111111111111111111111101111111111101011111a11111010111001101111
101111111110101110111001111101111101111111111111111101a111101111011011011110011111111110011111111101111111111111111111111011011111111111111a11111111111111111111
111111111111111011101011111111110011110110110100111111a111110111111111111110111111011111111011000111100111111110111101111101011111101011111a11111110111011111111
111110011011110111101111110111111111110111110110111011a101111101011111111101100111111111110011111010111110111111110110111111011111111111111a11111011011111111110
011011110111101011111111111101011110111110111110111100a011111110110110110110111111111011111111110001011110011001111101111111100111111111101a01111111101110110110
110100111111111110101111111111111011111111111101111011a111011111101111111110111111110111101011111111011000111110111111011110111011110111101a11111101111100111101
aaaaaaaaaaaaaaaaaaaaaaaaaaaaaaaaaaaaaaaaaaaaaaaaaa1011a101110000222212022100112101211120212201110101111111111011010111111101110110101111111a11110110111110101111
0101011011111110111111101011111111110011111111111a1110a111111111222121101211110211111222220102211111111101100111111111111101001111111101001a11111111111111111101
1101001100111011111010111111111110100111111111111a0111a111111111010021202122120211102122212112111101011111111110111011101111100111011111111a11011111111100111111
1111111111101011110111110111111100111101111011101a1111a111111111011112111220011120121210222121111011000111111111111111111111110100111111100aaaaaaaaaaaaaaaaaaaaa
0101110010100111111111001111111111111110111110111a0111a01111010120100122211111221120202001101111101111110110111111111101111111011100011111111111111111101111111a
1110101111011101011111011110111110111110111001111a1101a11101001122011111111112101221212222111111111001111101111101011110111111111011110111111101111111010111111a
0111111101011100111111111010111001110111110110110a1110a11111101111201112220012202112202202112201111111011011111101111111111111110011111011011001111101111101011a
1111111001011101110111101110111111001111111100111a1111a01111110122010222011221122012221222012110011001111010111101011111111111100110111110000111101111111111011a
1111111101111111111111110001110111111010111111101a1101a11111111121121211220212012212110202121201110011011110001100111111111111111111101111110110111111111011110a
1010110111100111011011101111110111111111101111111a1101a11101111121121222211120222111102121210111101100111011111111101110111110110111101111101011110111111111111a
1101111111110101111111111111111111101111111111011a1011a11111111112122212102121122122120212112211111111111100001111011111111111111110111011011011101111001001101a
1111111111011101011011001111101011101111111101011a1100a11011111112122021121102221102220112121210010010111111111111110111111011111111111111111110110101111000111a
1110111111101111111111011111101111111111100111101a0000a11011111121012221122112221220222121200000111110110110110111110110011111101111111110111111010111111111010a
1110101010111111011111101111110101111111110001111a0011a11110100122002210201221122002212112222101111111101111110111101111011111110011110101111011001111101111110a
1110111101111111001111111111111011111110110010100a1110a11110111121221011210211012221001221121101010111111011101111111101101001011110111111111011101111101110101a
1110110010111011101100111111111111101010100010111a1011a11111111100112102220102222000112101121220111011110111011111111111111011110111111111011110111111111111011a
1111011110111101011111111110110111011110111111110a0100a10011110101112120120221112202121222110121111111111110111111111111110100111110111101001010111101011111101a
0101111111111110100101000101111111111111011111111a1110a01111011120202112110121111122112012102221111011011011111111001111110100111111011111111111101111111011110a
0101101101011111011111110110111111001110101111110a1111a01110110120221110202212201100211221120011101011011110111011101011111111011111011011111111110111011011110a
1011111111111101111111111111110110101111111100111a1100a11100101110110202212012120110212012111111111011111101011011111010110111111111011101110011111101111111111a
10111110101110111011011111111aaaaaaaaaaaaaaaaaaaaa0111a11100110110021120102112002010222211220211111111111111011111111011111101101111101111111111111111111111011a
01111011111111111101111111100a010111111111111001111011a11011011001222012122222021112101021200111101111101110111111111101111011111110111111111111111111111111001a
10101110110011111111111111011a110111111111111111111111a01001011111220222122121102202101201111011110101110010011110111101111111011111111000110111101111001111011a
11101111011011111111111111001a011111011011011111011101a10101111121221212111111221202212020102021011111101110111011111111111110011111110111111111111011111011111a
01010011111101011001011111000a111101101110111101111011a110011111211212211021111110022220122211101111110110011011111110111111110111111111110101111100011111111111
22212210111221222212021111111a111110001111111111001101a110111111022200112222122012221012221122001001000111111111111111111001110110000111111011111110111111110111
22121220122122102102121111111a011111011110111111001110a111110111011202211020211102220111022221111111111101011010111111111111111100111011111110011111111111011111
02210121122120121222011111101a101101111111111111110100a111011101221002111121112212221102202212101011111111011111111111111110111110110111111110101011110111111111
02220010211021212111120111111a111111110111111111101100a001111110201110021011012202212102111021111111111111111111111111111111111111101010111101111010011111111111
21111221212111202210111111111a011111011111111111111111a010011111222212222211012102201022021121110111001111111111101111010010011111101011111101111111000010111111
21210122201220211101211111101a011011110101101011011111a101111111022221122111222202120211011122111011111011001111101111111110111111101111111111111101111111110111
20112211202212222121120111111a101011110111111111111110a101101111011111111011111101101110110100111111110101111111111111101110010111111111011101111001111110011011
12111021212211002210221111111a111011111101011111101111a010111111110111110101100111111110110111111101111101111111111111111010111111111100110111011111111111111111
11220122112222222111211111011a101111110111010111011111a111101111111111111001011011111110110101111011111111101101011111011000101101011111101101111101011111110100
22221111222112102121221011101a110111111111111011110101a111111111111111110111111111111101111111011011101111011111110101111011110000101001101111111111111111101111
01211221120111112112211110111a111100111111111111111101a011111111110111011011011111111111111111101111011101111111011011111111111101111011101110111111100111111111
21001122222010022011221111111a111100110110111101111011a111111101011111011101100111011111101111001110111010111110111111011111110100111111111111111111111011110111
21022122101221111112111111111a110111111110101110111100a101111111111111111111111111111111111111101111111110111111101111101111110000111111110010111110101011111111
11112000212201221212211111111a101111101011110111101111a111110111111111101101111000110111111111101111011111101100100011001111111111111111111110111111111011111101
12021210022211111110111111101a101111111111111110111011a111111101110111111110101101111111111111101110111111110110011101111101100111111111111111111111100111110101
11110212211101221211111011001a111110111111111011101101a111111111011111111111111111100111111101111111111101111001111011111101111111110101100001111111111111100111