5 117
11 16
33 66
133 4
119 28
87 41
58 104
120 99
88 88
142 93
1111111111111111111011110111111011111111110011100a11111111111000111111111111111011111110111110111111111010111110111011221221021100000211122222211021011111010100
1111111111111011111110101111111011100111010111110a10110010011010111001111011011111111111111101111110111011110001101010212102102101011110122221110202100111101111
1101111111111010111111001111111011101100111111111a11111011111101111010111111111111110111111011111011111111101111111001101211210221101101222211211102211011111110
1111110111111110011001110111111101110111101111111a11111110110111011011111111111111111111111111110101111100110011011111212222112221121212102212210021210011111111
1111110111111111110111111111010000101101111111111a11101001111111111101110101111111111110111110111011111011111110111101222022021122212121011110110101211010011001
1111111010011101111111111111111101011011010111101a11011101111111111101001001110101111001111101111010111101010110001111211220111111112000211220221102001111001111
1110111111011110111111111111111001101011101111111a10111111101101111111111111111011111111110111111111011111101111111110022012022210212221222221220212011111111111
1111111111111011111110111110101111111111110111101a11111101011010111110101011111111111111101110110111111110111111110111222211001121122011102221121012011111111111
1111110101111110111101001111100011101101111111111a11011101101110111111111111111111111010111111111111101111010111110011211022221012111101211210121211211110111010
1111011111111110011111111110111111001110111111101a11111011111100111111111111111001111111111111111111001011011110111011110110220010011201221221111222201111111101
1111111111011111111101110111110111101111101111111a11011101111111111110111111111110111111111111111111111101111100111110202221002121201222111102120001211011111111
1011111111101010001111111011111110110111111111101a01111110101111101110111011001110110111101011110011011011101111101011102220102120021011210011220200201011111011
1111111111111011101101011011111111111111101111111a11011011111101011011011111111011011101101111101111111101110110111011021012221211120122102112010202001111000011
1011111110110110000111111111101111111111111111010a11101011111111111011111111101111111111001111010011111122121011002020012222022121111101001211110122011111010111
1111110101011111011110011111111111101110101111111a11111110011111001111101111111111011101101101111111101120022222120221120102012122122100012020121220211101111101
1101111111010111110101110101110011001111011111111a01111111111111111111111110111101100111111111111111111111201221122212212101222122211221111011210011210111101111
1111111111011111111111101111111111101111101111111a11111111111111111111110111111101110111001111111111011122120022202220122202202121122222012210222110001011110011
0111111111111111111101101111111001110111001111111a01101111111110011111111111111011100111111110101110101121122020111110222221212221221011102211212021011111011110
1111111111110111111001111100111101110110111110111a10100011111111111111111001111011000111111111111111111120122210021120200120212202211220122122111111211111111110
0111011110111110011111101011111101101111111111111a0110111111011111101111011011011111111110011101101110012021abaabaabbabbbbbbbbbbbbbbbbbbaaaababaababaaaaaaaaaaaa
1110111111101111111011111111010111111101111110011a1110111111111101111111011111011011011110111111110111111012a221120222202112020120122121111010111111111010101111
1111110101111111110111111111110111111101111111111a0010101101111101011111111111101111111101110111011101012112a022212202122121220122211111100111111101101011100011
aaaaaaaaaaaaaaaaaaaaaaaaaaaaaaaaaaaaaaaaa10111110a0111111011110101111110111111111011111010111001111101101112b121210201222222221212212020111111111111101111110111
1111110111111111100011111111011110111111a11111101a1111111111111011100110101110011110101101111111011101111121a021012022210212112212201101110100101111111111111111
1111101100111111111111110101110111111111a11101111a0111011111000110111101111001111101110111111110011011111102b202102021201022211110222221111111111111111111011011
1110001111101010100111011111001110011101a11111111a1011111100011111111111011101111110111011111111110011112210b220222222102102022111102110111011111101111110110111
1011111011110011110100111111111111111110a11111110a0111111110011110110000111021102211110221201201101222002222b210202112012212011012110110110111011111010111111111
1110111011111011110111111111111111111111a11111001a1101011101011101101101122210120111111011120121210121111002b211122020202200221121202111111011110111011111111010
1111111111011111111111101111111111111011a11101111a1111111101110011101101221122202212202111120121020000212100b112221221201220112202220111111111111111011111111111
0111110111111101101110111111000011111111a11111111a1111111111101111110111112012121111220121222210022001111121b210222202221110122020122120111111111111101110111101
0110110111101111100100110111011110111100a11010111a1110111111111111111111012222022222020010112012110221212220b121021111102122122221102201011101011011111100101101
1011110001100111111111111111111111001011a01111111a1001101111101111111011211122212200220120102222201212102202b101220102111101201220002221111110010010111110110011
1101111111110011111111111010111101101111a10111111a1100001111101011111110200102200220101121212221121211112211a020110212101221121220100111110010111111111111011111
1101000010101111111101111111111111111111a11110101a1101101111111001111101121101222012111112021112211102101222b022110211122221112012221211111111111111111111011111
1111101111111111111011111110111111101011a11011111a1011111111101111111001020221222100220210220221010220011122b021221112212101012110212221001010111111101111111010
1110111011100110011110011110111011101100a11111111a0101110111101111111111111222221120112201122121211122211122b102110112210122220112211211111111111111111111111110
1101111110111011110110101111011111111111a11110111a1101010101111110011101122101122112201212202121120211112212b212202221122211012120002221111101011011111111011111
1111101111111101011111110101111100111101a11011111a1101101111111111111110222122211221111212120021121112011112a221112111221122111211221110101110111111111111111111
0111101110010111111111110011111111111111a11110111a1011111111001011101010010221210202211111001102111110011011a212200121221021201122110210110011111110101110111101
0111011110011111111111011011011111111101a01101101a1110111111111011111010112211221011101110202122101210212112b212012202220211111211220211001111111011111101111010
1111111111110111111011111011111111111110a10111111a1111111111110111111110120001020111022212221221012122111121a200020010221212221000020201101111111101110110110111
1111111110111101010001101111011011111111a11111111a1111101110111111101111221221222022122112222222110220210221a121112022220121101000201211011111111111100111111111
0111111111101111100111111011111111111111a11111110a0111110111111011111011111121200200200120122022210222201222a110210202011002212221202121111111111111011110100111
1001110110111111111111110101111110110011a11001100a1001111110011110110011121210200101221102120012212111011122b200000112121110111201212121011010110101001110111110
1111111011101111110111111111111111111110a11110111a1110101111011110011111212012212002121021122122102102111101a011111011111111001011111101111111111111011100111111
1111110011111010011111011111111111111111a11111111a1111110111101111100111111112222111202112220120110200111101a111111111111110111111111111011111011101001111100101
1011111101111111111111111111111110111111a11111011a1011011101100011011110021201211222222122111110021110111111a111110111110101111111011111111111010111011111111110
1111111111110110111111111111011111011001a11101101a1111101000110111111111212122112001222011021210110022110111a101111111111000110101111111011011111011111111010111
1111111101111101011111111001111111101111a10111111a1111110111011101011110022212210001222122212202221211011111a110101111111011011111101111010111101101011111100111
0111101111111111101110111011111011111011a11111110a1101101001011111110101201212112222222002211121201011011101a011011011111001111111110101111111111110011111011111
1110111111111101111101111101101111110011a11001111a0010011110111111110110212212211000121002221220111101111100a111010111111110011110011101111110111101011111111011
1110111011110111112121211112222101211121a22112221a1011111111111111111011221110111110221210210122210021211111a111001111001111111101001111111111111100111010111110
1111111010111111111121222122122201012222b11012012a1111011101111111010111112202110222211220112212101112211101a111110110111111111001111111111111011111110100111010
1111101101111111112112112101122122112111a21212112a1111101111110110111011210121112011212121110100221022211111a110111001111111110101111101111011110100110110101111
1111111111010111101122221011112112202111a11111221a0011110011110111110111221202021221111110211112221201200111a010011011111111111111111100011111111101000111101100
1011110011110111112011120202222111012111a11211222a1111111110011101110011100111211112212221112102112112111111a111111101111111111111111101111111101111110110111111
1111111001110101112112122212112100012122b22121111a1111111111111101111111100111101110022101200002101011210111a110111101111111111111111111111011110011101111101111
1100111111011111111121021110221222112211a22221120a0011010111111111111101111111110011111111111111111010101111a111011111111010000011101101111111111110110011111110
1111111111101111102212202220111212201121b22121110a1111111111101111111111010110111101111111101111111011111111a111111111110111111101111111111111010111011011011111
1111111101110111012222120010102211021222a10111121a1110101111111011111110111111100111110110100111111110111011a111111111111011111111111111111111101111101100111111
0011110111110111012220112222112020211101a01121221a1101111110111011111011110111110101100101111110110111111111a010111111101101100101011111111111111011111111010001
1111111110111110101022220122111211112200a22212001a0111111111100110111111011111111111111111001011111111111111a111011101111111111111111101111001101101111111101111
aaaaaaaaaaaaaaaaaabbbbbabaaabababbbbababb21221121a0110011101101100111011111111111111111111111111010111111011a111111111011111101001110101111011111110101111101111
a111111111001110112101222111122011110211212012101a1011111010111101111111111110111100111111101111011111101111a111111111111101111110111111010011101110111110111111
a111111111110101012222220222221021111201011111111a1101100011111111111111001011001101011011111111101111001101a011111111111111111001101111010110111111101110011000
a011011111011101111212202212110210211221021211121a1111110011011101101110011011011011101111111110111111011001a101010111100111111111111111111111110111101101111011
a111111011111111112111002221211112122102010120122a1111111110001111111111101110111111110111101101111110101001a111011111111111111011111111111011111110110111011101
a111101111101101012102111212002200010211211012122a1111111110001111111110110110111111111111101111111111111111a111101111101101111011011011111011011111111010010111
a110111111101011110202201021211112120001012021112a1111111111110011111100101111111110101111101111011111111101a111111011111100011110110111101110011101101100011010
a101110111111101102222212110100212221102212112012a1111110111111111001111101111111111110111111011011101111111a111011011111010111111111101001111111111010011101110
a111111111011101111212021122120212211221100121212a1111111011011101111101001111111111111111111111001111110111a011111111111101110011101110111101111101111111101101
a011111111101110112021120221120122220210101221212a1111111111110011110111111111111111111111011100111110110011a111111111011110111101001011110110111111111110010110
a111011111111111112222122201112212112212201111121a1010111111011110011111111111011011010111111111111101100111a111111111101111111111111111011111100111011111001111
a101111111101111111112222221120012122202101112122a1111111111111111111111122121221100101221121010202102021111a111111011111010111110110011011111011111111111110001
a001111101111111110110021220210222001001121221222a1111101111001111110100121210201002220120112012002201101111a100101111111101111101100111110110000011111010111111
a100111101110011112112111212212222220121112001100a1110010100111111111111112121210122010220122112210002111101a111111010011101101111111010111111111100011111101111
a101101111011111110201211221000012120200220112121a1111111111111011111101111201100021102121212012011010001111a111111111101101001011011111111110010111111010111111
a111111011111111012110212110111101122121221212111a1111101111010111111011102112012112211211222121212021020111a111010011111011011011011111111110101111001111101110
a111111011010011111220221212222021020022011121112a1110111111101111011111120111112021202102202121020122111111a111000111111101110221100211212212221212122011122111
a101101111111101102211011112111112111211120211112a1111111011110111011111121222201012211122122200022222220111a11101001111111111111220babbbabbabbbbabaaaaab2111111
a110001111111110110220201012111211010222211112002a0111111001111010111111111211121122110121122112011012020101a01111111110011101001111b1221012201112212112b1020111
a111110100101100012212211012020011221110112221222a1101001110111111101111022001111222121022202222102220011111a11011111101110010112000a0220222111212212211b1110211
a111101111001011101110111111111101111110111110111a0011110110010011100101122112211111221212122121111110121111a11111111101111011121222b2110102210201111222b1122110
1111111111111110110011110111011010111111111111110a1110111111111101111010111201011100201221111121010221221110a10111110011111111122112b1020212212211220012a1211111
1111111110111111111101111111101111011111111111111a1111011011011101111001101221221220012212122100202220011101b10212102122221121021222b2022102210222122121a2020011
1101111111101111001101111111111101101111111111110a1101000111111111110110110211111212221111222202222111121222a22112112112112220120222b2120020121122102201a2111211
1111111111111101101111101010011111011001111111111a1101111110111111111110112110222211221101010221212112200112b11101021000121202122212b2122110220222111122a2102111
1111010110111001111101111111111111101111111101101a1101111111011111111111111211211201102201111011221112201121a12012220022112212102222b2120112021011021012a2212101
1111111001011111110100011111011111111001111101110a1110101111111011011111012101021100221222221111122122121112b12220111111201221102222b0222211211121122221a1021111
1111111010111111111000101111111111111011111121122a2201210010212121222222120111022212211200121110210111211222a22201221112121022110022b2222002212110121111b1220111
0011111111011111111111111011111111111111000221110b1012222222220200102121121112120110111212122100002220111222b21111111111121221112212a2011022101212022222b2221111
1111111100110110111011110010111110111110110121221b1002220211222201222220212202111220201221222022022212010122b11121002000111011220211a2200222011121221111b2000111
1101110111101011111111111111101111111111011010111a1102221211102201011110022212021210012100120121212122021222a10120120212101210122102b0222211201122211011b1121111
0010111111111111111111111111111111011111111120022b0212112122021101112022122001001021202212111112110210111120a10211211202021212002121a2211221111121012211a2020211
1110101101011111111001111111110111110101111212111b2222211212111221201221221121122110101120211101201102201212b02021021011201121122200a2121212001000110212a1221210
1011111111101111010111101111101101111110111221200b1222211221222121002222121102122122020222201020200001120121b01100211120201211011122b1122211121021201101a1110211
1111111111011110111111110111111101110111111022200a1110112222212111112201100112012211112212011121221021000112a01101021122012222212201b2011121221202120200a2101211
1111110111111111010111010111111111111011111211111b1111111122101111222012022222000101100211021212220121220211b10121201121102112222022b2122221122200212021a2012210
1100011111011011111111110010101011011111101202121a1111021102121112112202222002011021222112220112101221101011a20001202121102121210122b1212101121011202210a1122210
1011111100101110111111011100100101111111111122222b2112220112111211012010122211120011212211121011110221111122a02202121110011011212212b2022220212201110212a2110110
1110110111101110111101011111111111111111001120210a0212212210121111122101002220201210021122222101011211110021a21222211001022122201212b2220102212122222211a1211010
1011111111101101111110111111111100101101111210112a1112212211211110101111221101222100112222012212102212211211b12012121200111021121211a1122111010102210221a2210211
1011101101111011101111111110111011111111011211212a1211121011202222002021221212212212211110221111111111211021b22211110100002222222210b2222212110221121202a2001010
1111111111111110111111011111100111111111111022210a2112221121211111021212112120220211202122210101122212201122a10012121021010200202201b1210220102022100211b1201111
1111111111110011111110111011111111011111111110112a2010110112210212112021211011111111101111011101111111011112a01111102222110222100120b1122110221122022222a2002110
1111011111011111110110101110111111101111111101011a2120220122221211222022120101111011111111111001111111111121b01200222121112012221211a0222022111010220101b2220111
1011011111011111010101111101111111001111101211110b0211210121012002112122221101110111111111111011111111111200a01222121120121210112112b1020200211211200221b0021211
1111100111111111110111111010111111011111111112111a1112221222210121220201201111111111111111111111110101111212b00011202101212112202211b0222221101110112211a1221201
1011111111100111010011101111111101111110101101111b1211202211111212210012121111111001111100110011111111111121a20222212022120220122122a2222121222221010012a1020111
1111111100101111111111111111111111111111011120101a1022122021120122211121221111011011111111111101111011111221a21021020201222122221012a2220111010111111111a1111111
1111111111111111110111110111011101111010010111111b0111212112111211212222101111111111111111100111111110111222a21101012221102121211102b1111011111111111110a1111111
1111111110101111111111011011111010111001011221120a2020102022122121222121110111111111110111111101101111100201b01102221212022212021112b1021010111110111111a0101111
1111101111111111111111101101111100111110111122221a0101111001111011222002211111111111111100110111101110111222b12121002021101102101122b0121101010111111101a1111111
1111111100110111011111010111110010010111111221120b2011112221212221222211101111111111110111100111111001111021a12222221111212201022221a0201111001111110001a0101110
1111111111111111111111111011111110111111011120112b2222211122002020121110200111111111101011111111101111111121b10011121212121221110121a2021011110111101111a1111111
1111111111111010001111111011100011010101111122101b1112012122121122222221111111111111101111111011111101111111a11111111011111111111111a1110111101111101111a1111010
1001111110111110111001111101111111100111111212121a0102211121121121212220221110111011010111010101101110011101a11101111111111111111111a0111111110111111111a1111111
1111111111110111111111101111111111111101111100101a1201222112011012111112121111111011011011111111011111110110a11111111011111101111111a0111000101010111110a1111111
1111111011111011111010001111111111111111111222012a1221220102202001222111211111011101111111111111101010101101a11011100111010101011111a1101110100110111111a1111111
1110111101111111111111111111100111111111000210000b1222202200122211112221211011111010111011111111011001011101a11001100100111110011111a1001001111111111111a0111011