87 107
9 13
70 114
113 102
152 18
149 1
79 30
122 118
9 42
144 103
11111011101001111111111111110010111011111111101110111101a0101111111011100011101110111001110111111101111111111111101101111111111111111122bababaaabbbbbbbaabbaa011
11111111101111010001110111101111001111111011111011110111a111111111111001111111110111111111111111011111111110111111111011001110111111100212101212012121221110a202
11111101110111111011010111111011111111111111111111111101a011011111111111111111110111100111111111111111111011111011110111111111111111012011210110102010112112a201
11011111111111111110111111111011111011011101101110111011a111111101111110111101111111111110101110111110011111101111110111111010101110112120202201220222002111b220
11110111100111100111111011111111110111101010011010000011a111111100110101100110011111111100111111010110010111110011011001110111110110110122221212222220210200a202
01011101111111111011010001001111111111111101110111110111a101100111011111111100110111110101011010011011101110110111111101011011111111101212120212101222222222b202
11111111111111101111111110111111111111111111110110011011a101101111110111111101011111111111111010111111111011111111111111111110111111110210202222222222022212b221
11110011111101111101011011111101111101101110110110101111a111111100110111111111111111010111111111101111010111011101111101101110101011002211012210222122001212a211
11111001111111101011001111111101001100111111011100111101a111111110111011111111101111011111101111111111111111110101111111110010111100111112222212112212021221b121
11111111101111110110011111111101111111111111110111111011a111011011111111011111110101011110110011110001010111111101111101011110111101111212221012122222112202b002
11110111111101011110111111111111111111100111111000011101a111111110100011111111111011111111111111111011111111110111110011001111101110110221222220222212222222b211
10111111101100111101111011111101011011111111011111111110a011111001101110101110111111111011010101110111110111111100010111110111111011112112121222022220112222a202
10011110111011111111111111101110100101111011111111111111a111010110000111010111111111101111010111111110101110110111101111101010111111012110022222122221221102b221
11110101110111111111011110001100111110111011001110101111a110111111011111011101110111111110111111111111111010011111111111111011111111102101212121221120121222b202
11011110110101111010110111010111111111111111111111110101a111111011111101111101111101111011111111111111110111111111111111111101111111002120222222212201120220b220
00111001111111111111111101110010111110001000011111011110a110111011110211212110201021101000122111111111101111101111110111111111111111102102220222122200222222a221
11011011011011110100111010111011111111101100111011111111a111110111112212122110011211202121112001111101111111011001011111111111111101112110112102211122222122b220
11110111111111111011111010111101110110011111110111111111a111111101112102021010220102012121102111110111111101011100010110111111011011111010221222012111010001a211
10111111110111111111111111111011101111111011111111111011a011011121111012112201002211012221212011100111111101111100111111010101111110111010221020101222111102a110
11101010111111111101110111101101001111111111111111111111a111101121211022022021122120221220222111111101111110110001111111111110101110111111122012212221122201a220
11011111111111111011111111111100101101111111111111111110aaaaaaaaabbbbaabbababaaabaaaabaabbaaabaaaaaaaaaaaaaaaaaaaaaaaaaaaaaaaaaaaaaaaaaaababbabaaabbaaaaaaaab000
1101101110111111111111100110111111111111110111101111110111110110212201221111211101202210210222211110011001011011011001111111110101111111121202100212222122001012
0110111111110111111111011111111101101111111111101010110111111110121222112201201111211101211111111111110101111110110111101001111111111111110122020121021021022210
0111110111111101111011111111111110111011111110101111111111111111011202212111211222212112121101111011111111111101111111111111011111111110101012201011102011021122
1110110011100101111111111111111111111111100111111110100111101101011202211212222211121220111201211111111111101100110111101110111111111110100212112102121122210112
0111111111111111110111011011011111111111111111110110111111011101212211110222210210221211110012011111111111111101111110110111111111011111121122222120212022021121
0111001111011111111010101111111111101111011010111100011111111111201201112021101111211011101111011111111111101111111111111111111111111111111011112222120112100102
0211220011211212120101101011101111110111011111110111111111110011212212112222212122000010202212210110001011011110111111100111111111111111112102101211112020022111
0220002202212121122222110101100101101101011111111111111111111011012222212111222212212101021220101111111111011111111011110100101111111111120220012022112211120111
2121200210111012110010212001111111110111101110111111111101110111212012122120222110220221110212011011010111111111111101111110111111110111111012112001122012010111
bababaaabaaaaaaababaa0112101110011100111111111011011000111111110122110100012111121121221101110101111010010110110110101111011001111111100122220020101212112222221
02202221211202201122b0021111111111010110111011111111111110111111011221201020202022221021102020210110111101111111101011110100111110111110121121221212212122201212
21221202121022022020b0121111101111011010011011111111110111111001121111000111122201020201112121210110111111111101111111111111011111111111112122112211012101212021
20212121211210102121a2120000111111111111101101111101011100011111210122212202120022121100222211201110011111111111011111111111111101100100121110112121111210201112
12111010112002222212b1211111110111111111111111101011101111111111012122200021222022122111002012110011000111111110110111111111110101011111110111111111111111111111
01112021120221210222b1100111111101101011101101111100111111111110222112121121022221100222112221211011001111111101111111111111111100111111001111011110110111001111
11102222221221122011a2221111011111111111111110110101011101111111021010212222122221212112121111111011111110111111111001011001110111111111110110111001111110111011
11212001121221212211a1011111111111011111110011010111100111111111020111112112220220212111111212210111111101111111110111111011110101101011111101111111111111111111
22122012012012121112b0120111100010111001010111111111111111111111102221101120200212012101022121211011101110101011110110101011111111111101111111011111001111011111
22221121210211211001a1111111111010111111111111111111111111100011212202122210221121212002021222111010101011111101101100100111101110111101010110110011011111001110
22122001211012212102b1022111001111111111101110111111110111110111202120002202121122212222100221111010100100111111101101111111111111111011111111111111111010101111
11121201122211011011b1112101100111111111110001111111111101111111012122001211022221220211211101201111111111111101111111111001111011001000100011111110100111100111
20011111211221122200b1111111101111100111110011011111111111101101212122022121112212211102001011110111111110111110111111011111111101011111111101111001011011001111
20122212111121222121a2012110111111111001010111011101111111111111221111011010201220221201101111111110111100100111110111101011111111111111111110011111110101111111
22222112222212011202a2121111111110110111001111111111111111011100220212021002220211112202222112201110111110111111111110011111111011101011111001111111111111111101
21020022201211201111b2121111111111111111100110111111101011011011202002222102111021220110111102111111100111111011111011101101111111111111011011011111110101101101
12210210020020211100b1221111110110111011101111111111111111111100111101111101111110100101100111111110111111111111111111110111111111111111111011101111111111111101
21202111112212212212b0121111111111101101011101100111111111000011111101110110010110110101111111011111110011110110011111101111110011111011111111110111011011111011
22201121122212100222a1201000011100101011110011111111111111111111111111111111111110111111110111111111111111111111111111011101111111111111111111101111011001111111
11222011221211111120b2122110111111011110011101111111110111111011001111001110111101111111110110111111110101101011101111111001011111110111111111101111111101110111
12122212111221010222b1121101011111111111101111010010111111111110111111111111011011101110011111110111111111101111101011111110111111111111111011011111111111101011
12101202221220111102a2122011011101111010111111111011101011111111101110111110111110110111111111010101111111111011111011111111001011100101111111001111111000111110
22210112202122111211a0111111110110111110111111111011111111101111111101111010011001111011011111111111111111101111111111110110111111111111011110111110111111111110
20121110121201212100b1012111111111111111111111011011111111111111010111011011101101101001101011101101111101111101101101101111011111111011001111100111111111110111
00222101110111122201b1022011111101111111111111101111101111111111111110010110110110111111011111111011011011111011011111011111011100111110111111101111111111110110
21001121012001221221a1120011111111111110111101101110010111111101000111111110101111111111101101111110101110011111101011111111111110111111111111101111101011111010
11202111201122212002b2022001011111111111110111111111111110011110011111100111101111111111111111111100111111111111111010011111111111110111111111111111111101111111
22011111021211112102b2201101111111111111101011111111111111111111111111111111110111001101111101111111100111111111111111111111110111111111011111111111111110111111
11111111111111110010a1111111111011111101111001111110111111111111111111111111111111111111110111110111011111010111111111101111011111110101111101110111001111011110
11111111111111111101a1111101111010111101111101111111101011111101111011111011111101110110111111111111010101111111110111111001111110001111011011111111010111111101
11111110111111111111a1111111111111111111001101111110101111111111111011111010111101110011101111001100111110110111111011111011001110101101011111111011111110111110
11111111011111111111a1110011111111110110011111111111111111110111111111111110111100001111101111110001111111111110111111111111111111111111111111111110111011110111
11111101101011011111a1101110011011111101111010011111011110111011101101111101111111010110111011111000111111101101111111111101111111011111011111111011111111111110
10101111111111111111a1101011111110111010011011111010111111111011011111101111111110011101111111011110011111111010111111011101110111111100101101011001101101111111
11110111001110100011a1011101101110111111111111111111101111111111110110101110111010111101111111100110011111011111110110110011111111111110000111100111111111111111
11101111111101111101a1110001101111111101111011111111011110111111111101100111101101111110110111111111110111111111111111111011101111111111111111110111111110111111
01111111011111101111a1111011111111110111010111101111101111111011111111111011111011011110111011011110110111111111111111011100111111111011011001111110111111111001
10111111111111111101a1101111111111110011001111101111001111111111111111001011110111111111110111011111111011111101111011111101111011111110011011111001111111110111
11101111111101101110a1110101111011011111111111011110011111111111001100111111111111011111111111111110111111111111101101111111110011111111110111110111111111010111
11010111111111011101a1110101111011110111111011111111110111110001011101110011111111111101011100111110111110111011101111111010111111101111011110111111111101111111
01111111111101111110a1110111110111001110111011111111110110111111111011011111111111110010111111110110111001111111111111011101101111111111111111111110101111101110
11110111101101110101a1111111111111111111111111111111111101110111111111111101011110111110111101111100111110111101111100011111101110110101100111101111111011111111
11100111011011110111a0111101111101111111101111101111111001111111010111111111111111101111111111111111111011111111111110111110011111111111101011110010011110101100
10001011011111111101a1001111111110010110111101011101111111101100111111011101111110111011111111111111111111111111100111111001011111110111101110111111110110011011
11111111011111111010a1011110111110111111111011111111010011111111111111111111111111011111111111111011000111011111101110011011110110101111111111111111111111110111
10011111101111111111a1111111111111010111010101111111011101110111111110111111111110111101111110111111111111111111110111011111010011111101111001100111111111111001
00110111111101111111a1111111101111111100111111011111011111110110011111111111110111011011011111111101010101111111110111111111111111101111010011111111101110111111
11111111011101111011a1010111101011111111110111110001111011101001101110111110110111111011111101101111111111011111111111111111111010010011111110011111010111111100
11101111111111111111a1111101101111111111111111011011011001111101101111110101111111111111011111100101101111111110011011010101111111111111110011101111111100111111
01111000101111101111a1111111001111111101011101111111101111111110010011111111111111110101011111111011100111111111111110111111011111110110110011110101111111111111
11111111100101111110a1100111011111110111111011111111101101101011111111111111111110111111011011001011101111110111111111101111101001111111111101111111111101111111
01111101101111101111a1111111111011111111111111111111111111111101111110101110111111111010011111111010001111111011111111011011101111111111101111011111111111110111
11111111110011100111a1110101111111101110111101111101111111011000111110110011111101111111110111111101111111101110011111111110001110001111111111111111111111101111
11001101110011111001a1111011111111110111111111111111111111111111100111111111110111110110111110111111101111111111111110111110101111111111101110111111111111111101
10111111010111011111a1111011101011111011111111111001101101111101110111111111111001110011111111110011111111111110011111111110111101011011111111111111111110001011
11111111110111110111a1110111011111001111111101010111011101111100111111111111011111111011101111111111101011111010111101001111111111110111100111101111111111111111
11111111011011100100a1111101111100110011101111111011111110111011111101111011111111011111111011101111101101111111011111110111110111111111111111011101111001000111
11001111111100011111a1101111111111111111111110000110011101001111111111111111011110101001100110111122221222122221122211210022210101110111101111111111100111101110
01011111011111111011a1111111101011110110111010111111111111111101111011111111001111110010101010111002212202121102202211100121122220002101102112121210020222201121
11110111111101011110a1111110111011111101111110111010011111011101111110101111011111111111011011111112220112122100112011022001021122011201222012000011220111111112
aaaaaaaaaaaaaaaaaaaaa1011110101111111101110111110011100011111111111101110000111111111111111111111102212111110202211012201021111211001212101121221111201210012220
1111111111110111110110011111111111111110011110011011111111000101111111111110111111110111101111111010112121112012222211121201110211111122112212001122000111202221
0110011111001101110111111111111011111111011011111101101101011101110110011101111111111000001110101122101202222000100211110022101221201121200221121201221021120202
1101010111101101111111110111111111101110111111010110110110110100011001111111111111111011110111111112202112221111220222120211020222222111221111101122222021221111
1011011101111100110101111101110101111111111101111111111111111111110111101101110001010001111010111120022201212222021001222221112112210120011012122102222100112021
1111111111111101111011110011111010110011110011101111010101101010110111110101101101110101110001111101011101122112202201220222222211121021102100221121222202202111
1011111011000110110111101110111110010111101111101011011101111111111111100111101110111111110111111102102022221221101211221011112012212102022122222120202211221222
10101011111011111110111111111110011111110111011101011111111aaaaaaaaaaaaaaaaaaaaaaaaaaaaaaaaaaaaaaaabababbaaabaaaabbbaaaaabbaabbbbbabaabbbbabaaabaaaaaaabbbaaaabb
11111110111111111111011101111111100110110110111011111111111a101000111111101110111111110101111110112101001201221111111122202211101122122100211200102021022121122b
10110101111101111111110111111011111111111111111110110112121a21111aababababbbbbbbbbaabbaaaaaaaaaaaabbabbaababaabbbaaabbabaabbbbbbbbaaaaabbababababa2120021012211a
11111111010110011111110111111111111110111111111101010111212a22122b1120100110100101111201110111011101220112011220211201022002110222212101111020020b2000120201022b
11011111110101111001111101001011111111111111111110111011221a10111b1210102222122111211211111011110122120122221211202121202001121212012122101001011b1022001212020b
11111111111111111101111110011110111111110011111011010110202b10222b2202112211121202111111111111111011111212111210112221222111122122100122211022110a2112021021201a
11011101010111101111111110111101111111101100111110011112121b22220b2210120122122221110001111011111112002100222222202222002002102202100122222111221a0001212002100b
11111111011101111101111111111111111111111111111010111111112b01222b1122222222221211102011111111111112001211122222122201110112222122220222022121202a1201220012222a
11111100111011101011010101111011001101111111101111111112210b12022b2111220111220010210111111111111121212010221202222222102200120221212111211120221b2101202112200b
10111111111111111111111111111100111010110111000110111111122a21211b0002022121121202202211111001110011202111022121222211220221022122220222120201122a2121211110212b
11110111111101111101111111111111110111001111011110000111211b11211a1101021222201021112211111111111122221221220222210212222222111020120221122100212a2012222212212b
11111011111011011111111011111111111111111111110101000100122b10211b1221110202100112221111111011111110111201221220222122221022222220220120102110221a1200201220221b
01110110111111111111111111110111111111101111111011111110221b12202a2012212221212120111211111110111022121211121112222102212222221102220021221100021a2110122210012b
10101011111111110001111100001111111110011001110111011110112b01222b2220222022102122102110111111111011122122021020220122122022212212202222222101202b2221111120100a
11011010101011111111111110011010111110111110111111101112211b22210b1111110022222011212011110111010122120201212020222120202202222202222112101212222b2222002120211a
11101111101010110100111101111111101111111111110111110112112a12022b2222221102211111012010101011010110010111210202022120212222222201220222022100210b0211210122211a
11111111101111111001110110010100111111001111011011111111112a12011b0112121101211212222211110111111102111022222022211120202202222002222210212221220b0121211121120b
11110111111101111011111101101111111111101110011110111111012a02022a1201222012001120211211101111111011002002120222220200122212212212022011220222211a2102211221110a
11011111110111101011111111111111111110111111111110001112202a20220a2221202220010112110111111111010021211211002102222122022202222102222021211222122b1121100112120b
11111110111101101110011001101111101011001011111111110111111a10000a2110201220122011222111100101111121211122112022122211111022222022000212111022012a1211211122210b
11111111111111011111101111011100111111111111101111111110212b21220b0211200101201222210111111010111112202211122222220100222222211021110012122021221a1110211210111a
11011111111111111111111101101110010001101101101111111110222b20011a0211120221022202121011111111111111110111121022222222121210222101202222201011210a00222201022120
10110110111100111011110111111111111111111111111111101011220b22121b1212200111012112221111101111011101111111122001212212100200100211120121110111111a10111111111111