82 117
142 11
119 62
21 117
14 80
40 0
6 53
144 59
112 56
14 61
1111110110101111101110111101102120112121001010121011210211111111100110111111111111011110110101110111a1111100a1110110a1111111011110110111111111110110111111011101
1111111111111111100111101121210101112211221121122112202111111011101011111111011011111111111111011001a1101011a1111011a0011111111111110110101001111111101111111111
0111111111111011111111111102101221221122120102221110222101110111110011111011011111011111110111011110a0101011a1111111a1011111011101010011111101110101111111111110
1111111110111111101011011121212102011100221211221221212201111111110011111101111111010001011101101111a1111111a1111111a1111111011111011111111010111011111011011110
1011111110111110111111011201101121001110021110112211120111010111111010001011101110111111100011110111a1111111a1111101a1111001111111110111101111111111001110111111
0111111110111110011011111122220021111221022221110210010111000011111010111111111101110111010101110111a1101111a1111111a1111101111111111111110110111111011111111101
1001011111111111111111110222221112111102121221121001022001011111111111111110110110111111111111111111a0101100a1111101a1011100110111111101001011111011111111011010
0111011111011101111111111110011101201100112121211102221111111100011111101111111111111011111111011111a1111111a1111111a1111111010111111011000111101011110110111111
1111111111111110101111101111211220220210211212121121102211111111111001111111110011001111111111101111a1111111a0111111a1011001111011110111111101110101001110111111
1101111111111101011110101212111120121021211212020010201111111111111011101111110111001111111101111010a1111111a1111010a1001111111111111101011110111101101111111111
1111101011101010111101101020221221212220200202100111210101110110111010111111101111101111111111111111a1111101a0111111a1111000111111100011111111111001101011111011
0011011111111100111111111121222212022122220120122011121110111111110111101111111110111111111101111110a1011111a1110101a0110111110011111111111111111111110111101111
0101111011101111001110111122011021111200101011122202112111110110100110111111011111011111111010011010a0111100a1111101a1000111101011010011111110111011111111110110
1101011111111101110111111022102101211221002212021110221001101001011111001100111110011111111100111111a1101011a1101111a0100101110110111111110111011101001111011111
1101110111111111111111101202222122212111212120112211221211011011101101111111011101111111111100111010a1111111a1111100a1101111111111111111101111010111111111111111
1111111111111111111110111021122221121220111121200222220201110111111111011111111111111011101111111111a1110110a1111111a1111011111001101111111111000011111001111101
0111011110110111111111111111111111111111110111111111110011111011011110111100111111111110011001110111a1111011a0011110a1011110101110111011111011111101111111111111
0111110111111111111110111110110101110111111111111110111011111110011111111111111011111111011111111111a1110111a1101111a1010111011110111111110111110011111111010111
1111011110111110111111111111011101111111111111111011111111111101011111101111111111011111111110111111a1110101a0011010a1111110111011111111111110110101111111111111
1111111101011111111101101010110011111011110011111111111111111111101110111111111011111101010110111111a1111111a0011111a1101110111011111111111011110111111111101011
1111111111111111111011111111101111111111011101111111001011101100111011111101011111111101111111011101a1111110a1111111a1011011010111111110110110111111111011111111
1011101010111111111001101110111100000111001111011001101111111111111111101110111111010011101101111111a1111110a1110101a1011101111000110011111111101111111111101001
1101111110011111101101011101011100111111011110111111110110110111111101010111011011011111111101111111a1111110a1100100a1101111011111111110011011111111101101110110
0111111111101111011110011111111111011111111111111110110111011111111111111110111111111111111111111101a1111110a1110111a1100110111101001111111111111111111111101111
1110111101101101101011111111111111110111110011110011011111111111111111111011111100111101111111101111a1110111a1111010a1111111011111111111010111111111111111101111
1111111011110111111011010100110110101111111111100111101111111001010111111110110111111011110011111111a1111111a0001011a1111101011110101111111111111111111111011011
0011111100111111111111010100101110110011101110110111111101111111111010111101111011000111101111101111a1011101a1101111a1111111111111111111111011011110110111111101
1111111111101111111101011000110011101111111100111111111001110111111111111111111001111111101011111111a0111111a1111100a1110111011011001111100110100111011111111101
1111011011111111111101111100111010101111110011011011010011011101111111111011111111010110111011111111a1001101a1011101a1111110011111111110111111110111111111111100
1111111101111101111111101111111110101111110111111111111111011111110110111110110111001011111111111101a0110101a0111111a1111111111011111111111111111111111111101110
1100011011011111111111000011100111111111100111111111100111111100111110110100101111110111111101111111a1011110a1011111a0111110111111011011101111111011111101111111
1111111110011111110101111101101011011100111111011101010100111111111010011110011011111011111011011011a1111101a0111110a1110111101111110011111111101101001111111111
1111011011101111111111010111111110111111110111111111111110111101111011111111101011110001111111000110a1111111a0111111a0100011111111011111010111111111101011011101
1111111111110101111101101010011111111101101111111111011011001111111101111100010010111111110100010111a1111111a0111111a1111110011100110111101111110111010101111010
1101010111011111011011111110110111111111111111111110111111110101111111111111010111101011111011011110a1111111a0111111a1111111111111110111011110111110110100111111
1101010011011111111111110111101111101001010111111101110111001111111110110111101101010101111111110110a1111001a1111101a0011111110110111110111111011111111111111011
1111111111110111101101111010111111001111100111111101111111001111110111111111111110101111110111111111a1100111a1111111a0110110111011111110111001110111111111111101
1110001111110101111110111111111011111101011111111111011101111010111111111000011111110111111111101111a1111110a0110111a1101111111111110101101010111111111111110111
aaabbabbabbaabbbbaabaaaaaaaaaaaaaaaaaaaaaaaaaaaaaaaaaaaaaaaaaaaaaaaaaaaaaaaaaaaaaaaaaaaaaaaaaaaaaaaaa1111101a1111110a0111111111011111111101110011011110111110111
012222212010201021101111001101111111110100111111111111010111101101111111110111111111110111111111111110111111a1111101aaaaaaaaaaaaaaaaaaaaa11111110110111101110010
222011211200122121200211011111111110101011111111110111111111001101101111111111111111111111101011111111111101a110111011111111011111111111a11111101000111111111111
020212222201122022000001111110011111110111111111011111110111101111011011110011111111011111111101101100122111b212121100111121212011110111a00111111111111111111011
201101210222022210112211111011111101111110111111111110111111101011111111101111111111101111100110000212212101a112012200022220111211110111a11100111111011101111111
210100111002211221202201111101111010111111111111001111001111111111111101100110111111100100011111122121100212a220021212122222211111011111a11111101111111111111011
111120011210222212221011011111011110111111110111111110110111101111101101011111011111101111111101002210112101a010122202112100111200012201b22000221221122200222011
212121022121202220222101111110101111110011111111110111111111101111111011111101111110001111111001021211000100a101000210021212111212212211a21111112212111012200212
222222202021221012222101111210010111110011011111111111111101111011011011111111111111111111111111021002120022a011200012210111211212021010b21212111201121212112211
100222210222221012222210210220111011111100111111000111111110111010111111101111011111111111101111000221200202b112221212220202201212022221a12222211022122221112122
002212212222221020022102011110111100111111110111111101110110111111011111111111111111111011111011110221000222b221221112202222221022111122a12020020200101112200121
222002211222222212221111121212111011111111011111110110101111101110101111101111101111100111111111110222102212a122122122011010122212112221a22011021022121212111020
222222022022111202220200221212011111110111101111101101001011111010111101001001101101101111110101122110202221b001112122212221212021122010b01202122222202112112220
222200202222201202102012111122111101011011111111011101111001010111111100010111111101111011101100121210222222a212222212222220102221122201b11022101221110122121212
222122002220020112202211212211111110111101111110111111101111011011111111001111011111010111101111111112122222b120221222222222112112122101a12021121120201210011012
222222222211211022122202100201110111111111011111010111110011111111101111111111111111110101101101122021201221a200221220002022121222222221a12012111222202221202222
212212222221222011202121211121111111100101011101111111111111011110101011111111111110110110101111112021112222b122202121222202221212022220a02112202011121012111100
221202022201220011022102121210111010011111111010110010111111110111011111101101111111001011111111012012012222b021022221022222221220222221b22201121101020020211001
021210200222021211220021220221111111110111110111110111111111111111111111111111111101111111111111111122211220b220221021211020222210211222a12001002201102121122012
222020222022220211220222122221110001011101110111111111111110011111101111101001111011011110111101111010022022a022212222222222022211000221a22120211020011000220211
221122221202111120200012222021011111110111111100011110111110101111110111101111111110111110111111002212122222a010022020212222212111222102b21202202110110212210121
122222222212222222022120020012111011111111111111111111111100111111111111101110010111110101111001011212222102b222102202212102122211222101b11212220112201121111222
bbaaabbbbabbbbabbbbbababaaabbaaaaaaaaaaaaaaaaaaaaaaaaaaaaaaaaaaaaaaaa001110111100011110011011011122021110122a211202220122222122220211200a12121110012110122222211
21021121122112220212020122210210111111111110101110101111111111011111a011111010111111111000110101111020222022b121221212122022012122202020b20012200011221111112022
01211222010222022020210212211210011111101011101111110110110011111111a111111111111011110110111110122202222222b222222020122202211212202121b12111011221111121012202
20022122002012212222121212212211111111101110111111011111101111111111a111101110110111111111111111121111202002b122102222210222221122222222a00110011110211022221110
22122012201222122221220212101111111111111111011111110101110111011111a111111111111011111101111111122021120222b202222201220211222022222222b11200222201121102111202
00202200202222222220222002222111111111111111111111011111011011111010a111001110110111111111111111120220100122b122220201122221002221122012a20112221012212211112022
20220002122220022220212120221001111111011011111111101101101111101111a111111111001111111011111111121212012022b102221222122112020011202220a22121011112111212121202
22222220002222222202112222220211111111111010000111111111101110111111a111101111111111111111111100111211111221b212110212200222222222212222a11112021121211222121210
20220202120221221202222112120111111111111110101011111111000111111111a111111111111111101111100111122012220012b211022211020012220112202012b21122100012211201021112
00222222121022122222222121221111111100101011111111010101111111111111a001101110011100110011111101121102111221a020222220221121222222222222b12121010211021211101212
12122220220122120222022222122201111011111110101011101111111111011110a111111111111111011111101001021001110021a022222220222122220222122210a20102110221220212122122
22222220122122002212011111202101111111011111111111111111111111111111a101111111111110001110111100100111012221b110102222222222221221202212a21012021211112011221020
21220002222122222222201121222211011111111110111011111011011111011111a011111111111111101110011111111110112112a122121022201211111212112002a02121220122210211212012
21221222221012022202221122222210111111111111111100110111011111111101a111011011111110111111000110110101011121a211202022211022212112102121b22210000210012221112211
22202111221222122212102122022210110011111111101110111111111011111011a101111111011111111111011110111111111212a001101212100120121222021222b22022101211121121110120
21222211212120022212222212022010111101111111111110100110111111111111a111111011101010010111111101110111112012b202202221222222012221021201a11011110111111011010111
02102221112212122110202212222211110111111110101111111110111010111111a111110011110101111110100110111110110011b222022212121222111110112211a11111111110011111011111
12120000200112022201111112002211110011111111110101111111111110111111a011011111101111111101111111011111102111b222220212010110212120121201a11110110110110011111111
12122212220022022101211012111110011011101110110111101111110101110011a111001011011001101111010111101110111111a111101111111111101110111110a11111111111110111010011
12222112211212212112020200100210111111111111010011110111110101111111a111111111111110111111110111111011111111a111101111101111110101101111a11110110111011111111110
22112001212122220212200101021201111111111111101110111100111010001111aaaaaaaaaaaaaaaaaaaaaaaaaaaaaaaaaaaaaaaaa000101111011111111111111101a11111111101100111001111
2101111121121220211122111220020110100111110111101110111111110111110111111110111111011110111111111111111111111111001101111010101111011011a10111111011111110111110
1011202121021210100201211001000101111111111111011001111110111011011111111111111111111111111111111110111011110011110111111111110011110011a11111011011011101111011
1011101121220211200112120220220010111111011101111010001111011111011110111100111111011110111111111111011111011111110111101111010111111101a11101111110110001101110
1100221221221112221202022112221100111011111110101111111111111111001111111101111000111111011100011101111110111101011111110111111111101111a10101110101011110111111
2211121112102120221102110100121111111111aaaaaaaaaaaaaaaaaaaaaaaaaaaaaaaaaaaaaaaaa0101101011011111110111011111101101111011101111101111111a01011111111111111011111
0221201112211222201110111112200101110011a110111110011110111111111111111111111111a0111111101011110110111111111111110101111100111011110111a10101111111111111110110
2111121121102100221222120212121011101111a101101111111011111110110111111111110101a1111011100111011111111101110111101111111111110110111111a11011111111100001111111
2122112210121100111102211011201111110111a000101110111111111111111110110111011111a1011110111100101111011110111111111111111001110111111111a11111111111101111111110
2122112212020121111102001222211111111111a111111111111111011111101011101111110111a1100111100111111111111111111111101011101111110110111111a01011011111111111111111
2211212222111022220112222001121011111101a101011111111111101101110110111111111111a1110101110111111001111111111001011011111101010011111110a11101111011001100111110
1202012121002112211121102122121111111011a111100111111111111110111111111111111111a0101101100111011111111101110111111111011001101111011111a10101111111110111111011
1111112022212222122212202010201110111111a011111011111110111111110110110110111110a1011110110111011110110110110111111010011111100111110111a11111011100111111111111
1211212022021120110121111012121111011110a111101011011111111111101110111111111111a1111111110111011110111100010111111110001111100111111111a11011011111011111001111
2121012220012201211221112222221110100100a011111011101111111111011011110111111111a1111110101111111111110011101110111011111110111111111111a11111111111110111111101
0122122011122220122202122121201111111111a011110110110011111111110111111111111001a1111110110110111111111101110110110111110111110111111111a11110111101111111111111
1111111111111111111111111111111111110001a011111111110011111011111001111111110011a1110001111111111111111111111101111111101101101111111111a11011010111111111110011
1111111101101111001111001111111111111111a111111111101111110011011110111111110111a1111011101111111111010101111110111111111111011101111101a11011110111111010111111
0111111110111110111111011111011010001111a011111111111110111011100111100111111111a0111111111111101111111100101111110011111111101111110111a11101111000101111001111
1110111111111111111101111111111111110111a100011101101101111111111111111011111101a0110111010111011111111101011111100101111111011111111011a10110101111111111101111
1111111111111101110111111011101111111011a111111111001111111101111101110110011111a0111010110110011111111111011011111101010111011110111111a11110001010010111111011
1111111110010111110111101111010111111111a011110011110110111101010011001111011101a1011111011110011111111111101101110111110011111101110111a10111010111101111111011
1111110212120112220122112221121220112111a110111011101001111011111011101101110111a1111111100101111101111111111111111101011011110111111111a01111111110111011111111
1111111122010201221110111212112211022111a111111111010111101111110111111111011001a0111111110111101111011011111101110101111111111111101011a11110011111111111101100
0111111011122222000111210222001021212101a110000111101111111111010111110111011110a1101111001110111111101111111110111111110111011111111111a11111111111100111111111
aaaaaababbabaaaabbbbaabbbbabaaababbbbaaaa100110111111111110111110111111011111101a1111111111111110111011111111011001010011111111101111111a11011101101011111111011
10011112020000100211021112211222220210010111011111010001111101110111111111110111a1111111111111111011001111101111011111110101111111101100a11111101011111111111101
01111112210221222221022202212102122120111111110010101110110110111111110111110100a1101101111011110111111100101111111110110101001111111111a11111011111111111111111
11010010200122112211121112202120120021101011011111111111111011111101110001011111a1011101101110101111101011111100111101111100111110110110a11111011111111111110111
10111112011222212121111112221022121211111100110111111011111011000101011011111111a0111001111111111100111111111010111100011110110001101111a11100111011110011011001
01011112010112122022121211222122110211111111011111111011111101111111111111111111a1111111011101111101101001111101110111111111011111111010a10110110111101111101111
11111111001112011201122122021101122211110001111111111111111111111111101011111111a1011111111111101111101101110111011111011111010001111110a11111111111101111111011
10111101122121122221122122201002211000111111111111011101111111111011011111111111a1101011101100101110110011100000101101111111110111111011a01111111101010110111111
01100010201110121211122221021111101101111011101111111111101111110000111011011111a1110011111110111001111111111111011011111101111111111111a10111101110011011111111
11111112122220102110220010010212211221111111011011110111111111101111111111111011a1111110101111110111011111111111110001011110111010110101a11111111101111111111110
11111122110111110110211011021022222011111010100111110100101111101111101111111110a0011111100011111111011111101111110011110011101100111100a11101111111011110011111
11011100111011000102112020120112121101011010111111111111011010111111111111111111a0111001111111101111111011101110110101110111011110111011a11111111001111111111010
11111120010120221200211122110211221221111111011111110110110111100111111110101011a1111101111111111101111111011111111101111111111111100111a11111111011110011111111
11101112012222112201021110111020202221001101101011111111111110111101010110101111a1110110111111111111111011111111111100111101111100111001a11011110111111101111101
11111111222112122111022111200221112221111001101111111111011111111101111111110110a1011111111101111110111111101101111111111111110111111111a11111110100111011111111