136 8
151 114
10 5
61 62
53 92
19 17
65 50
151 78
114 60
54 6
211012220211211112122112211111101111110012212112121101220211a02211112111111111100100111111011111a11111011111111101101111000101111100111111001101011111111101111a
121202100110122222212221101111111111111011121202220221020121b21210210211111101111111111111101111a01101111110111011111111101111111110011110111111111111111010101a
010220222222020221211221221202011201111121222102111121211112a20112101111001111111111001101010011a11101111111011111111111010111111111011101111101111111111111111a
211112221222202211212120212100202101111202222112120012101221a22212112111110011110111111011010111a11111111111101110111111111111001111011110111011111111011011100a
001121111101001000221110222210022211111102222122211121012011a02011000211011111101111111110111111a11011111101111111111100111110111000100111111011110011101111111a
120202122122221222222220200122201221111112212122111221112011a21112120111101110001011111111110111a11111111111111111100111111111111101111010111101101110111110111a
222222212222022221200121100211102111111121212012212111211121a20022201111111011011111111110101110a11101111111010011101010011101110111011011111110101111101011010a
121022022220212222002122022212220011111121222221211211112011b10102212211111111111110110001111010a11111111110111101111111111111111000011111111111111001011110110a
122202221222222210022200122101122111110211122210120122022221a21111011211111111100010011010100011a11011101111111111111101111111010001111111110110110111011101011a
222210202201210222222022201121121121000221101122122101212212b02111211110101010011111110111110110a11011011110111111011111110111110011111101010111101111110111111a
120212211212102222002222022000212111011102022222222211110122b01221122111101110011111011111111101a01111111010111011011110111001111111011111111111111111111111101a
111201220221102021222121212111120121111122012001120121211111a20011222211100111111110111111110101a11111111111111011000111110111111111111111110110111101011110100a
222011212202222222222201110202221011110122202111121210211121a01112001201011111110111001111011111a00111111111111110111111111111111101100011111111111011010110010a
210110222200122122222222221222101211100112111112112112221000b11201112211111011111101111011111111a11111111111111111101111101111110111100101111111000110101110111a
020212102012010220000122222201020211111121121122212112122122a22220212111111010111111111100101111a11111111111011001100111111101111001111110110111001101010101111a
122022012202021222022222210121112101101021121112212111220111a11212201211011111111011111111111111a11111111100111101001111111111101101111011111011111000111011111a
202122222222222011222222200122212120111112210020222220102122b10212112211111011110011111101011010a11011111111011111110111101111011110111010111101011101111111111a
122021202002122220210222221102022121111012022212002210221222a01112122211111111111100101111110111a10111110101101011011111111101111111110110110111110111101110111a
021112202201210220102122022010122220101110102220111222000111b11121102010110011111111001111011101a11110011111111101011111111111111111011111110101010111101100111a
021120020212222012222122222112221011111111122201110021221100b12212212101011011111011101111111111a00111011111010111101101111111001101111111111011111110101111011a
222110201011112220222100211122110121111021010112111112110201a21112002101111111111111111011111101a11111101101111011011111011111111011110111010101111111101011111a
110112121102021221001222011121121211111022012121221022200220b20111021200001111111101111111110111a11111110000111111100111111111011101111111011111111111110010101a
100102122212222112122011211121211221110011111011111111111111a11011111111011111110010111111111111a01111111001111111111111011011111111111111011111111011111110111a
101112112111221222011221200221100201111001111111111011111101a11111111111011101110111011111111011a11010010111111111011110111111100011110111111111101101101111110a
011112021011221110122011212222211121101111111111111111011001a11111011111111101011111011101111011a10101111111110101011111111111111110110111110110100111111111111a
110021212001011022212022200221121101111111011101111111111111a11010011011101111111110110010111010a10111011111111011110111111101110100111011110110011111101001100a
110121001111021222222020211210112111111101011111101111111101a11111111111110101111110111111111110a11000011111111111101101110110011111111011000111111011101110101a
111102111002121121120110211101112221111111111101001111111111a11101111111110111111111111111111111a11111011010111111101101110111010011111111110111111011011111111a
011122102021110122120021112101200100101011111011111111111011a11111111111010111101111111111111111a11111011110111011111111111110111011110110111111011111100111011a
111122101121222112121202022122020011111111111111100110111111a11001111111111111111111111010100011a11110101111010111111110111111111111111101011110110010101010111a
111012110212010212020020101201021121011111111100111111111110a11111101111111110111111110111111101a11111110111101110111111111111111111001110000111111111101011111a
011121221110112021022110010020200021111110111111111111111010a11101111111011101111111111001111101a11111111101111111111111111110010111101110111011111111011111101a
110122012220210121011221121101211021111101110101111111111101a11101110111110111111111111011110101a01111111011110111111011111101111101111111001111111111111111111a
011111111111111011101111111111011101011111011111111111101101a11111011111011111001111111111111110a01111101001111110111111111111111111101111011111101111111110100a
011111111111110111111111111111110111111011110011111111111001a00111111111111111110101101111101111a01111011101111101111011111111111110111111111011010110111111111a
101101111111111010110110101111110111111101011111112111102002a21021122222120221211111010111110111a11111111011101111010111111101111111111111101111111111011111111a
111011111100111100001110011111111111101110101111111211102202b12011121212101120222101111111110001a11111100100111011111100111110111101111110111111110101111110111a
111111111110110111111111001111110110011111111111112020201210a01111122210122102021110110111101111a11101111011110011100110111111111001111111111101111111101010011a
011111101111101100111111101111110111010111101101112222122222b01101222020211120202111111011100101a11011111111101111111110010111100101111110111111011111111111111a
101111111011111101100111111010011101111111111001102001220122a22012102211122211222111101111110110a11111101111111111111111111101111111011100011111100110001110111a
111011111001101110011001101111111111111111111111111001112222a00122121101202112221111111111011011a01111111111110011111110100111110011101110101111111101111111111a
111111111010111111111100110001110111101110111111111012110221a22111221122202010212110101110110001a11110111111111111111111111111101111111011111101111110111011111a
111011111111101111111111111101110001010111111111110222122002a21222001012210212121101111111011011a11111110111011111111011110010111011111110111111111101111110110a
110001101111011110111111101111110101111111111011100121121001a21120012120110112120110011111111110a10111111101101011101011111101001111111111111000111111011111011a
111100111111110011111101111111111111111111011100110122122122b02121210221222211212110101100111111a11111101111111011011100101111111111111111110011111111111111111a
100111111011100111111101111111011110111011111110111201100222b20211102111112112211101101101111111a11222221122001221221201021121212211111111011111110111110110011a
111101011101011001011011111101111101111010111011100022021220a10222112212111112201101101111001110a10101212122221201102022201200212101011110111100111111111000111a
101111111111101111111011110111111111111111101111022211210022b20201222220222111222111011111011111a11221022122121222121102222110211011111111101111110000110010111a
110110101011111011111111111101011111111110111111101221022202b22222220202122121121100111100111111a11020020200221110122121122102221111101101111101111100101111111a
111110011110111011111111111101111110011111111102102211112120a02222222212010202121011111110111010a11021012112211022001210100022112211011101111111110011111111101a
101111011011101110000111101011111111101011111112212221011212b22220010222122212221110110110111011a01020200011122202021110222000202211111111101111101101111111101a
111111011110111111110011111111000011101111101121200122220001b12221211211120222212111111110111111a10211112110221212212201122101212101001011100111111011110111111a
111111011011100110011111110111011111111001101102221021122200a01222220220202211220111011001100101a11221111211210221201102012001011101110111111110011111111111011a
111101110111101111011000110111101111111111110111122202220212a12212020100221221121111111111110011a11211210120111212111112111211120111111101011111110111011110111a
aaaaaaaaaaaaaaaaaaaaaaaaaaaaaaaaaaaaaaaaaaaaaabbbabbaabbbbbba12211221022222221122111111101011111a11211020201211112221201121012111211011011111111111111110111111a
111111111111101001111111111001111111111101111121021212222222220211001221222101211111111110111111a10102121220121211002021112212122110110111111101101111111111100a
111101111111111011111111111110110100100110111120120211022220222222021222102012221101111111111101a11212210201221111210200111222211211110011111111001101111011010a
010111111101111111001111101011101011110111111112220222122122222120211220012022010101110111001111a01222122011222221121221011222011211111111110111001101110111111a
111111111110111111011101110111111111101111111111220222220200220212222002202020221111101100010111a11120111111120221121111021101210211111111111111011001111110000a
011111100110101111111110011111111101111111111102112202112222222021221022202001212101101110011111a11222222210021011211210212012201011011101101111111111111111110a
101010011111110111011111111110111110111111111110111222212022222222201022222021222111111100110110a11120111222020222120111010021022210101011111111111111101110101a
111111111011110101101110111011111011110101011012011100202221221121210122222122110101111111111110a11120212211101220122112212210222011110111111011100101101111111a
111111111111111111011111010111110111011111111021100022100200222122122112210021221111110110111101a10111211101122211112121222101102111111011101011011001110111111a
111001111011110111111100111110111111111110110121222120222221122102122001221210022011111111111101a01122122012122011111201112110211201011110112122111111022122221b
111111111101111101010101011101100111011110011112010122222221222210201222022102211001011111011101a10121221211222021120121112212120011011122011210010001122020001b
101110011101111110101111011111011000111011111111212212000222222211022202221210122111110001110111a11021112000111210221112122121122111111010101212111221212111221b
111011011001111101111101110101101111111111001121122121122221201220120121102221111110111111011111a11212211210011101121210221112201210111112122202022102221211111b
111101111111111111111101011111101111111101111111101022011121111221202012212121111111111110011110a10012011121212011211122012121111200111122122112121111010101212b
111110111100011011011001000111111111111011111121002011102111221022121222222121111111111111111111a11211112121111222211120120021220210110122121011121111222211101a
111111111111111111111111111101110111100111011111120220211120122202221222200101111111101010111011a10010002120100121110012112202021211101120212222212102211110021b
110111101011110101010101100110111111111010111121111012022121212001220020201220101111111111111011a10212211012012021211110212222221010110120101121212200100111022a
010101111110011101111011110101101101111011111111121222222111222221122020212021101111111111111111a11201010222212020002211221202110011101111111022102121022121211b
111111111101010111111101111111111101011100111121112110121122221222101222112121111111111111111111a10201221022211202210121111202111211111111210122021221221111020a
011110111111110111011001110101111110110011111102000021221221101212012000112221111111101011111111a11111111221122112112211020120021111110110022100021020212201112a
101001111101111111111111111011111111101111111101121122210021222112221120211120100111011011110011a11211221111122012201022201111222111011112122012200211111112212a
010011101011011111111110110111101001111111111020210221111020120011221012102201111111101011100110a11211112110110022112101021001012211101012102220122012221222012a
111111111101110111011101011101100011111100011011210212102002201021022022222121101111111111011111a11111111011111111111111001101111111111121102011211102012220021b
aaaaaaaaaaaaaaaaaaaaaaaaaaaaaaaaaaaaaabbaaabbbbbabbbbabbbbbbb11222202200200210110111111111100011a11111110101101111111111111010111111011102202100202021201110111b
111111110111101111110111111111111110111211002121021102122122b11122100111110111111100010111010111a00111110111011101011100101111101111111122111221102122121120221b
111111101111101011111001110111101101102112001002122011201102a02221221111111111011010111111111111a01110010111111111111110111101111110111110120122022211022021102a
111110111111111101100111111111111011112122122122212122011002b12111220111111111110111101101110101a10010111111111111111110111100110111110122121221122002121211210a
111011110101011111111011111111111111111122111001122222000120b01212011111110110110101111111110011a11100111111111110111011111111110111111121112220020002111220212a
111110111111111111101111011111111111010220101100212122001120a21111201111111111111111110111110101a11011110111111110111101111111111111111120220121010211222112122b
000111110111111111111111101101101111110220120210022122001021a00021121111110011111111111111110001a11111111111100110111011101111111011101002111112220211210202121b
111011111011010111111110111101111111102121122211221110122122b22221111111111111111111101101011111a11011110111111111111111101111111111111102112122112112010022221a
101111111111111111111111001001011101110101212111200222111211a22011021110100001110111010111111101a01111110111111110111111111111111100101112121212022020002122121b
111011100111011111110011011111111110010002210111122111112200b12212102111110111010111101101101111a11111110111111111111101111111111111101112101210220211010012112b
111110111111111110111111101011110111110122212121211220010111b11112211101111111111111111000111110a11011011111111011111111111111101111111112222012111202201122211a
111011110011010111111101011011011001112212012202201111221212b21210111111110110111001001111101000a11110111111111011111111111111110111010110211222221201122102221b
111111111111101011011111011110111111110020111211111012212022a22121212110111101111111111110111111a11011010011011111111110111011111111111111201221112121210102122b
111111101110101111111111011111011111111101100211010021110212a21121110111111110111011111111111110a10111111011110001110111111111111111101110121012122001101112010b
111101111110111011111010111111111111102111110021111002011212b22022022111111111111111110011111011a11111000111111111110011111111101111111121221120121111122221112b
101111101111111011011110110110110110102200211210222202102221a02101022111110111111111111110111111a11001111000101111110111111111011101110121202111121221211122121b
111111111110111111011010011111111110012100200222010211010202a11102210101110111111110101111110111a10111111111011111011110100001111111011111212202021222121222221a
111110111111011110111101011011111011011022101120111001110210b22112222111010111011111110101110111a00010101111111111011111111111101111111110111111111101111111110a
101111110100110011111111111011111011112212221120221101211111a02121122110111111111111010111101110a11111110111111111011111011111111011111111110111111111111011111a
101111111011111110110111111111101101111122102220222110101022a01100022110101111111111111111111111a11111111110011101111111101111010110111111111111111111111111010a
aaaaaaaaaaaaaaaaaaaaaaaaaaaaaaaaaaaaaababbbaaaaaababaabaabaab22110121011111111110101101111011111a10111111001111111110111101111011111101111111010101101101101011a
011110111011111111111011111101111111101122210121210121111010212210122111101111100111111010111110a11111101011110101111111110010111111111111111111011111110111011a
111110111111110110111111111111100101011212201102110122212112122211211111101101111111111111011101a11110111111111110111111111111011010001111111111111111011100111a
111111110011111011101101011111111010112001122122011220202222122101212111111111110111111111111111a11111111111001110111111111111111111111101111111111110111011111a
001001011011111111101111111101110111112202011112121221002210222021211101011101111111111110000111a11110111111011011111111011110110111101111111001101111011111111a
111111111111111111111101111011110111101220222111110011122110112202212101011101011011110100101111a01111111110111101111101111110111101111111101011111001111111010a
011001101101111111111111011111010111012102111222202210020112121221112111101011001111001101101110a01111111111100111111111111101111111101011111111101111111001110a
110111111111011110111111111100111011110121221211110212200211211221222111011111011111110111111111a11110110111111111111111011111111110111111110011011101010101101a
111111111100110110110111100110111111101211112020212102001111211020021111010011111101110101110011a11111111111111101011111101110111111111110110111111111101101011a
001101011111111110101111111101111111012122111122210112122212121111121111111111111111111111111110a11111111011111011111111111111111110111111111111111111110100100a
110111111111111111111111111010110000110102011102022111222220200121112111111011110111111101010111a01111111111011111111011111111001111111100111111111110111111110a
111111110111110111111101111111101010111011011111110111110110111111110111101110100111111111011111a01111111111101001111110111111100111111111111111111011111111111a
111111111110111101101111111111111111111111111111111110111111111011111011100111111111101111011101a11110111111111110010110110111111111110011011111110111111111111a
011100101111111111111100101101110111111101111100111111111111111011110111111110111111111011111111a11111001111000111111111110111100111111111100111001010110111011a
110111111011111111111111111110111111001101111111011111111111101111111111111101110110101111011011a11111111111100011111111101110000111101110111111111101111110111a
111011101011110111111110111111110101101111011101111111101111110001111110111111100111111011111111a01011111110111111111101110110000111111111111000101011111001001a
111111111111011111111111111111011111100111011101101111011010111111111101110111111000111101111010a10111110010110011100101111101011111011111011111011000111111111a
111111000111101101111101101101111111000111110110111111111111111111011111110011101111111011011011a11111110111111110111011001111011111101111111101111111111111111a
011111111011011111101101100111111111111111011011011111111101111101111011111011010101111111101111a101111011101110101101101101001111011100010111111111011111011101
101110111001111111110101111001111110011010100101101111101111100110011111100111111110100010101111a111111111011011111001011101111111111110101111001110111001101111
111011110101110010110011111111011111111111101001110111011111101110111111111111010110111111100011a110111110111111101111101101111001111111111111111111111111111111
011111101001010111111111111011111111111011101100111110010011111111011111111111111110111111100101a111111110011111111101101111111101111110110011101111111111111111
110111011111011011010111111111110111111111111111111111111111111111110111111110101110111011101111a111111110101101111111001111111111110111111111111111100111010011